AAACAGCCAAGGTGCA-1	HY_ER+_ER-
AAACAGCCACAACAAA-1	LC_ER-
AAACAGCCAGCCTGCA-1	Immature_BC
AAACAGCCAGGAACCA-1	LC_ER-
AAACAGCCATCAATCG-1	LC_ER+
AAACAGCCATCACTTC-1	LC_ER-
AAACAGCCATTATGGT-1	LC_ER-
AAACATGCAATATGGA-1	Immature_BC
AAACATGCACCGGTAT-1	LC_ER-
AAACCAACAAGGCCAA-1	LC_ER+
AAACCAACAATTGCGC-1	LC_ER-
AAACCAACAGGCTTGT-1	LC_ER+
AAACCAACAGTTTCTC-1	LC_ER-
AAACCAACATAACGGG-1	LC_ER+
AAACCAACATAGGCGA-1	LC_ER+
AAACCAACATGAAGTA-1	LC_ER-
AAACCAACATTATGAC-1	LC_ER+
AAACCGAAGAATCTCA-1	Immature_BC
AAACCGAAGTACTGGT-1	LC_ER+
AAACCGCGTAACTACG-1	LC_ER-
AAACCGCGTGATTTGG-1	LC_ER-
AAACCGCGTTGAAGCC-1	LC_ER+
AAACCGGCAATAATCC-1	LC_ER+
AAACCGGCACATAACT-1	LC_ER-
AAACCGGCATAGACTT-1	LC_ER+
AAACCGGCATATTGAC-1	LC_ER+
AAACGCGCAACTGGCT-1	LC_ER+
AAACGCGCACGTGCTG-1	LC_ER+
AAACGCGCAGGATTAA-1	LC_ER-
AAACGGATCAATAGCC-1	LC_ER+
AAACGGATCACAGCCA-1	Immature_BC
AAACGGATCACGCCAA-1	LC_ER-
AAACGGATCATCAGTA-1	LC_ER-
AAACGGATCCCGCATT-1	LC_ER-
AAACGGATCCTGATTT-1	LC_ER-
AAACGGATCGTTAGTA-1	LC_ER-
AAACGGATCTAGCTAA-1	Immature_BC
AAACGGATCTTAAGTG-1	LC_ER-
AAACGTACACCTATAG-1	Immature_BC
AAACGTACACTTAGGC-1	LC_ER-
AAACGTACAGCACGAA-1	LC_ER-
AAACGTACAGGATTAA-1	LC_ER+
AAACGTACAGGCCAAA-1	LC_ER+
AAAGCAAGTAGGTTGC-1	HY_ER+_ER-
AAAGCAAGTTGGTTGA-1	LC_ER+
AAAGCACCACCGGTAT-1	LC_ER-
AAAGCACCAGTCTAAT-1	LC_ER-
AAAGCACCATGGAGGC-1	LC_ER-
AAAGCCCGTCCGTGAG-1	Immature_BC
AAAGCCCGTCGACTAA-1	HY_ER+_ER-
AAAGCCCGTGAGGTGA-1	LC_ER+
AAAGCCCGTTGCACGG-1	LC_ER-
AAAGCCCGTTGTAAAC-1	HY_ER+_ER-
AAAGCCCGTTTGTCTA-1	HY_ER+_ER-
AAAGCCGCAGGATAAC-1	Immature_BC
AAAGCCGCAGGCTAGA-1	LC_ER-
AAAGCCGCATCTTGAG-1	LC_ER+
AAAGCCGCATTAAGCT-1	HY_ER+_ER-
AAAGCCGCATTATGGT-1	LC_ER-
AAAGCGGGTAATGACT-1	LC_ER-
AAAGCGGGTACTGATG-1	Immature_BC
AAAGCGGGTTCGGTAA-1	LC_ER+
AAAGCGGGTTGTCCAT-1	LC_ER+
AAAGCGGGTTTAACGG-1	LC_ER-
AAAGCGGGTTTGCAGA-1	Immature_BC
AAAGCTTGTCCTTTAA-1	LC_ER-
AAAGCTTGTGCTAGAC-1	LC_ER-
AAAGCTTGTTGCTTCG-1	LC_ER-
AAAGCTTGTTTGAGCA-1	LC_ER+
AAAGGACGTACAAAGA-1	LC_ER+
AAAGGACGTGTTCCCA-1	LC_ER+
AAAGGAGCAAGTGTCC-1	LC_ER+
AAAGGAGCAATTGAAG-1	LC_ER-
AAAGGAGCAGGATGGC-1	LC_ER-
AAAGGAGCATTAGCCA-1	LC_ER+
AAAGGTTAGTTCCTCA-1	HY_ER+_ER-
AAATCCGGTATTTGCC-1	LC_ER+
AAATGCCTCGCGACAC-1	LC_ER+
AAATGCCTCTAATCAG-1	LC_ER+
AAATGGCCACAACAGG-1	LC_ER-
AACAAAGGTCGAAGTC-1	Immature_BC
AACAAAGGTGTTTGTC-1	LC_ER+
AACAAAGGTTCACCAT-1	LC_ER+
AACAAGCCAACGTGCT-1	LC_ER-
AACAAGCCACCCACAG-1	LC_ER+
AACAAGCCACGTAAGG-1	LC_ER-
AACAAGCCAGCTAACC-1	LC_ER-
AACAAGCCATGCTATG-1	LC_ER-
AACAGATAGAGGGACT-1	LC_ER-
AACAGATAGGTAAGGC-1	LC_ER-
AACAGATAGTTAGTTG-1	HY_ER+_ER-
AACAGATAGTTTGAGC-1	LC_ER-
AACAGCAAGGATCCGC-1	LC_ER+
AACAGCAAGGCATGTT-1	LC_ER+
AACAGGATCATGCTAA-1	Immature_BC
AACAGGATCCATCAGG-1	LC_ER-
AACAGGATCGTTAACA-1	LC_ER+
AACAGGATCTAGCTTT-1	HY_ER+_ER-
AACATAGCAAGCCAGA-1	LC_ER-
AACATAGCAATCCCTT-1	LC_ER+
AACATAGCACTAAGAA-1	LC_ER-
AACATAGCAGCATTAT-1	LC_ER+
AACATAGCAGGCTTCG-1	LC_ER+
AACATAGCATCATGTG-1	LC_ER-
AACATCATCAAACACC-1	LC_ER-
AACATCATCAAGCCTG-1	Immature_BC
AACATCATCGAGGAAC-1	LC_ER-
AACATCATCGCGACAC-1	Immature_BC
AACCCGCAGAGGAAGG-1	LC_ER+
AACCCGCAGGAGCAAC-1	LC_ER+
AACCCGCAGGGTGAAC-1	LC_ER+
AACCGCTCAATAAGCA-1	Immature_BC
AACCGCTCAATTGACT-1	LC_ER+
AACCGCTCACCGGTAT-1	LC_ER-
AACCGCTCATGCAACC-1	HY_ER+_ER-
AACCGCTCATGTTGTG-1	LC_ER-
AACCGCTCATTGTGAT-1	LC_ER-
AACCGGCTCGTTATAG-1	LC_ER-
AACCTAATCACACAGT-1	LC_ER-
AACCTAATCCAACTGG-1	LC_ER-
AACCTAATCCCATAGG-1	HY_ER+_ER-
AACCTAATCGATAACC-1	LC_ER+
AACCTCACACTAGCGT-1	LC_ER+
AACCTCACACTGGCTG-1	LC_ER+
AACCTCCTCAAGCGCC-1	Immature_BC
AACCTCCTCATGAGCT-1	HY_ER+_ER-
AACCTCCTCCGCAAAT-1	LC_ER+
AACCTCCTCCTACCTA-1	LC_ER-
AACCTTAAGCCAGTAT-1	LC_ER-
AACCTTAAGCTAAAGG-1	LC_ER-
AACCTTAAGGAGTAAT-1	LC_ER+
AACCTTAAGGGCTTTG-1	LC_ER+
AACCTTAAGTACTGGT-1	LC_ER+
AACCTTGCACAATACT-1	LC_ER+
AACCTTGCAGTAGCCT-1	LC_ER-
AACCTTGCATTGCAGC-1	LC_ER+
AACGACAAGAGGAAGG-1	LC_ER+
AACGACAAGAGGCTAA-1	LC_ER+
AACGACAAGCCTGATG-1	LC_ER+
AACGACAAGCTGGAAA-1	LC_ER+
AACGACAAGGCTCATG-1	Immature_BC
AACGACAAGGTGCGGA-1	LC_ER-
AACGCCCAGGCTGTGC-1	Immature_BC
AACGCCCAGGGCTTTG-1	Immature_BC
AACGCCCAGTCGCTAG-1	LC_ER-
AACGCTAGTAGCTGCG-1	LC_ER+
AACGCTAGTCATGCAA-1	LC_ER-
AACGCTAGTGATCAGC-1	LC_ER-
AACGCTAGTTAGAGGG-1	LC_ER+
AACGGTAAGTTAGACC-1	LC_ER+
AACTAGCTCCACCTTA-1	LC_ER-
AACTAGCTCCTGAGTG-1	LC_ER+
AACTAGCTCCTGGTGA-1	LC_ER-
AACTAGCTCCTTAGTT-1	LC_ER-
AACTAGCTCGCACAAT-1	LC_ER+
AACTAGCTCGGTTACG-1	LC_ER+
AACTAGCTCTAAGTGC-1	LC_ER+
AACTAGCTCTCAATAG-1	LC_ER-
AACTAGCTCTTAAGTG-1	LC_ER-
AACTAGTGTAATCCCT-1	Immature_BC
AACTAGTGTCATTGTC-1	LC_ER-
AACTAGTGTTCATCTA-1	Immature_BC
AACTAGTGTTTAACGG-1	Immature_BC
AACTCACAGCACGATT-1	LC_ER+
AACTCACAGCCGCTTT-1	LC_ER+
AACTCACAGCTATGAC-1	LC_ER+
AACTCACAGCTTATGA-1	LC_ER+
AACTCACAGGAGCACG-1	LC_ER-
AACTCACAGGAGTCTT-1	HY_ER+_ER-
AACTCACAGGATTTGC-1	LC_ER-
AACTCACAGGCGTAAA-1	Immature_BC
AACTCACAGGTCCTGA-1	LC_ER-
AACTGTTCAACACCTA-1	Immature_BC
AACTGTTCAAGGTAAC-1	LC_ER+
AACTGTTCACTGGCTG-1	LC_ER-
AACTGTTCAGCGCTTG-1	Immature_BC
AACTGTTCAGGAACAT-1	Immature_BC
AACTTAGTCATTAGTG-1	LC_ER-
AACTTAGTCTGGCAAT-1	LC_ER+
AAGAACAGTTCACTGT-1	LC_ER-
AAGAACAGTTTGTGGA-1	LC_ER-
AAGAATCAGAAAGGAA-1	LC_ER-
AAGAATCAGTCCTGAG-1	LC_ER-
AAGACAAGTATTCGTC-1	LC_ER-
AAGACAAGTTGCTGGG-1	LC_ER+
AAGACATAGCGGTTAT-1	LC_ER+
AAGACATAGGCTCATG-1	LC_ER-
AAGACATAGGTTACGT-1	LC_ER+
AAGACATAGTTAGCCG-1	LC_ER-
AAGACCAAGTTCCCAC-1	LC_ER-
AAGACCAAGTTTGAGC-1	LC_ER+
AAGCAAGTCATAAGCC-1	LC_ER+
AAGCAAGTCCCTCACG-1	Immature_BC
AAGCAAGTCCGTTAAA-1	LC_ER-
AAGCAAGTCGATTATG-1	LC_ER+
AAGCATGAGCCGCTAA-1	Immature_BC
AAGCATGAGCGCATTG-1	LC_ER+
AAGCATGAGCTTAGCG-1	LC_ER+
AAGCATGAGGCTTAGT-1	LC_ER+
AAGCATGAGTAACTCA-1	LC_ER-
AAGCATGAGTATTGTG-1	LC_ER-
AAGCCACGTTGGTTAG-1	LC_ER+
AAGCCTCCAGCACGTT-1	LC_ER+
AAGCCTCCAGTTTGGC-1	LC_ER+
AAGCCTGTCACGAATC-1	LC_ER+
AAGCCTGTCGGGCCAT-1	LC_ER+
AAGCCTGTCTAAGGAG-1	LC_ER+
AAGCCTTAGCGTGCGT-1	LC_ER+
AAGCCTTAGGACACTT-1	LC_ER+
AAGCCTTAGGTGTTAC-1	LC_ER+
AAGCCTTAGGTTAGCT-1	LC_ER+
AAGCCTTAGTAAGTCC-1	LC_ER+
AAGCGAATCAAACCGT-1	LC_ER-
AAGCGAATCATGCTCC-1	LC_ER+
AAGCGAATCATGTGGT-1	LC_ER-
AAGCGAATCCGGTTGA-1	LC_ER-
AAGCGAATCTGCAAGT-1	LC_ER-
AAGCGAGGTCAGGAAG-1	LC_ER-
AAGCGAGGTTTATCTG-1	Immature_BC
AAGCGCTGTGCGCGTA-1	LC_ER-
AAGCGCTGTTACCGGG-1	LC_ER+
AAGCGCTGTTGTGATG-1	LC_ER+
AAGCGCTGTTTGTGGA-1	LC_ER+
AAGCGGGTCCGCAAAT-1	LC_ER-
AAGCGGGTCCTAACGG-1	LC_ER+
AAGCGGGTCTTGTCTG-1	LC_ER-
AAGCGTTTCCCTGGTT-1	Immature_BC
AAGCGTTTCGCAATCG-1	LC_ER+
AAGCGTTTCTAAGGAG-1	LC_ER+
AAGCTAGAGCTGAGGG-1	Immature_BC
AAGCTAGAGGACAACA-1	LC_ER+
AAGCTAGAGGACAATG-1	LC_ER+
AAGCTATGTACTGATG-1	LC_ER+
AAGCTATGTATCTGGA-1	LC_ER+
AAGCTATGTCACAGCG-1	LC_ER+
AAGCTATGTGGACATC-1	LC_ER-
AAGCTATGTTACATCC-1	LC_ER-
AAGCTATGTTAGGTTG-1	LC_ER+
AAGCTCCCAAATATCC-1	HY_ER+_ER-
AAGCTCCCAAGGTCGA-1	Immature_BC
AAGCTCCCAATAGCCC-1	LC_ER-
AAGCTCCCACAGAACG-1	Immature_BC
AAGCTCCCACGTTACA-1	LC_ER-
AAGCTCCCAGTTATGT-1	LC_ER-
AAGCTCCCATTAAACC-1	LC_ER+
AAGCTTGGTAATCGGC-1	LC_ER+
AAGCTTGGTGAGGTGA-1	LC_ER+
AAGGATCCACAGGAAT-1	LC_ER+
AAGGATGTCAATAGCC-1	HY_ER+_ER-
AAGGATGTCCCATAAA-1	LC_ER+
AAGGATGTCCCTTGCG-1	LC_ER-
AAGGATGTCGGTACGC-1	LC_ER+
AAGGATTAGCATGCAT-1	LC_ER+
AAGGATTAGCGATACT-1	LC_ER-
AAGGATTAGGATTGCT-1	LC_ER+
AAGGATTAGGCCAATT-1	LC_ER-
AAGGATTAGTTAGAGG-1	LC_ER+
AAGGCCCTCCGCAAGC-1	LC_ER+
AAGGCCCTCGGCCATA-1	LC_ER+
AAGGCCCTCTCTAGCC-1	LC_ER+
AAGGCCCTCTTGCAAA-1	LC_ER+
AAGGTATAGGTTACGT-1	LC_ER+
AAGGTATAGGTTTACA-1	LC_ER+
AAGGTATAGTCAGTAC-1	HY_ER+_ER-
AAGGTCAAGACAGGCG-1	LC_ER+
AAGGTCAAGCCACAAT-1	LC_ER+
AAGGTCAAGTCAATCA-1	HY_ER+_ER-
AAGGTGCAGGCACAGG-1	LC_ER-
AAGTAGCCAAGCCACT-1	LC_ER-
AAGTAGCCATTGGGAG-1	LC_ER-
AAGTCTATCGACAAAG-1	LC_ER-
AAGTCTATCGATTTGA-1	LC_ER+
AAGTCTATCTTCAATC-1	Immature_BC
AAGTGAAGTTATTGCC-1	LC_ER-
AAGTGCAAGAGAGGAG-1	Immature_BC
AAGTGCAAGCAAGATG-1	LC_ER+
AAGTTACGTAGCTGCG-1	LC_ER+
AAGTTACGTCGCAATA-1	LC_ER-
AAGTTACGTTTAAAGC-1	LC_ER+
AAGTTAGCAAGGAATC-1	LC_ER+
AAGTTAGCACCAGGTT-1	Immature_BC
AAGTTAGCACGGTTTA-1	Immature_BC
AAGTTAGCATATAACC-1	Immature_BC
AAGTTTGTCGAAGTAG-1	LC_ER+
AAGTTTGTCGACCTGA-1	LC_ER-
AAGTTTGTCGATCAGT-1	LC_ER+
AAGTTTGTCGTCATTT-1	Immature_BC
AAGTTTGTCTAAGTGC-1	LC_ER-
AATAACCGTCTTGCAT-1	LC_ER+
AATACCGGTGTGCAAC-1	LC_ER-
AATAGAGGTAATCCCT-1	LC_ER+
AATAGAGGTATTGGAT-1	LC_ER-
AATAGAGGTGGACCTG-1	LC_ER-
AATAGAGGTTATAGCG-1	LC_ER+
AATAGAGGTTGAATCG-1	Prolif
AATAGCTGTGTTGTGA-1	LC_ER+
AATCAGGAGTTAGACC-1	LC_ER+
AATCAGGAGTTATTCC-1	LC_ER+
AATCAGGAGTTGCCTC-1	LC_ER-
AATCATCCATAGCGAG-1	LC_ER-
AATCATGTCACTAATG-1	LC_ER-
AATCATGTCCTCGATC-1	LC_ER+
AATCATGTCGATTTGA-1	LC_ER-
AATCCATCATCTAGCA-1	LC_ER+
AATCCATCATTTGCTC-1	LC_ER-
AATCCCTGTAAGGTTT-1	LC_ER+
AATCCCTGTAGGATTT-1	LC_ER+
AATCCCTGTGTCCAGG-1	LC_ER+
AATCCGTAGCACCACA-1	LC_ER-
AATCCGTAGCGTGCAC-1	LC_ER-
AATCCGTAGTGAAGTG-1	LC_ER+
AATCCGTAGTGAGCAA-1	LC_ER+
AATCCGTAGTTATTCC-1	LC_ER-
AATCCTAAGAATGACG-1	LC_ER-
AATCCTAAGAGGCTAA-1	Immature_BC
AATCCTAAGCTTAACA-1	LC_ER-
AATCCTAAGGCTATGT-1	LC_ER-
AATCGCCCACTATGGC-1	LC_ER+
AATCGCCCAGGCTTCG-1	Immature_BC
AATCGCCCATAGCAGG-1	LC_ER-
AATCTCAAGTCTTGAA-1	LC_ER+
AATCTCAAGTGAGGTA-1	LC_ER+
AATCTCAAGTTTGGGT-1	LC_ER+
AATCTTGAGCCACAAT-1	LC_ER+
AATCTTGAGCCGCAAC-1	LC_ER-
AATCTTGAGCCTCTCG-1	LC_ER+
AATCTTGAGCTCCTAC-1	LC_ER-
AATCTTGAGTCACCAG-1	LC_ER-
AATCTTGAGTGAGGTA-1	Immature_BC
AATGAAGGTTACGCAA-1	LC_ER+
AATGCAACAAACTGTT-1	LC_ER-
AATGCAACAAGGTGCA-1	LC_ER+
AATGCAACAAGTGTCC-1	HY_ER+_ER-
AATGCAACACTTAGGC-1	LC_ER+
AATGCAACAGTCTATG-1	LC_ER-
AATGCATGTTAGGACC-1	LC_ER+
AATGCATGTTGGTTCT-1	LC_ER-
AATGCATGTTTGTGGA-1	LC_ER+
AATGCGCGTAACAGGG-1	LC_ER-
AATGCGCGTCAGGAAG-1	LC_ER+
AATGGCGCAAACTCAT-1	LC_ER-
AATGGCGCATGAGTTT-1	LC_ER+
AATGTCATCATAACCA-1	LC_ER+
AATGTCATCCTACCTA-1	LC_ER+
AATGTCATCGGGACCT-1	LC_ER+
AATGTCCAGGACAATG-1	LC_ER-
AATGTCCAGGCTAATC-1	LC_ER-
AATGTCCAGGGATTAG-1	LC_ER-
AATGTCCAGGTTTACA-1	Immature_BC
AATTACCCAACAGCCT-1	LC_ER+
AATTACCCAAGCTAAA-1	LC_ER-
AATTACCCACAACCTA-1	Immature_BC
AATTACCCATATAACC-1	LC_ER-
AATTACCCATGTGGGA-1	LC_ER-
AATTAGCGTATTGAGT-1	LC_ER-
AATTAGCGTCTAACAG-1	HY_ER+_ER-
AATTAGCGTGTGTGGT-1	LC_ER+
AATTAGGCAGATTCAT-1	LC_ER-
AATTAGGCAGTAGGTG-1	LC_ER-
AATTCGTCAAATTGCT-1	LC_ER+
AATTCGTCAACCTGGT-1	LC_ER-
AATTCGTCACAGAACG-1	LC_ER-
AATTCGTCACGAACAG-1	LC_ER+
AATTGACGTCGCAAAC-1	LC_ER+
AATTGACGTGAGCACT-1	LC_ER+
AATTGACGTTATCCTA-1	LC_ER+
AATTGACGTTTACGTC-1	LC_ER-
AATTGCCAGACACTTA-1	Immature_BC
AATTGCCAGATAAAGC-1	LC_ER-
AATTGCCAGTAACGGA-1	LC_ER-
AATTGGACAGTTTCTC-1	LC_ER-
AATTGGGAGGCTGTGC-1	LC_ER+
AATTGGGAGTCATCCC-1	LC_ER-
AATTGGGAGTTAGACC-1	LC_ER+
AATTGGGAGTTAGCCG-1	LC_ER+
AATTGTGTCGTTTCCA-1	LC_ER+
AATTTCCTCAAGGACA-1	LC_ER+
AATTTCCTCAATGTCA-1	LC_ER-
AATTTCCTCAATTACG-1	LC_ER-
AATTTCCTCATGCTCC-1	LC_ER-
AATTTCCTCCGGTATG-1	LC_ER-
AATTTCCTCCTCGATC-1	HY_ER+_ER-
AATTTCCTCCTTTACG-1	LC_ER+
AATTTCCTCGAGGAAC-1	LC_ER+
AATTTCCTCGGGACCT-1	LC_ER-
AATTTCCTCTTAGTGA-1	LC_ER-
AATTTGCCACGAACAG-1	LC_ER+
AATTTGGTCAGGATGA-1	LC_ER+
ACAAACTGTACAAAGA-1	LC_ER-
ACAAACTGTCCCGAAG-1	LC_ER-
ACAAACTGTCCGCTGT-1	LC_ER+
ACAAACTGTCCTTCAG-1	LC_ER+
ACAAACTGTGTTCCCA-1	LC_ER-
ACAAACTGTTGACTTC-1	LC_ER-
ACAAACTGTTTGGGTA-1	LC_ER+
ACAAAGGTCACGCATG-1	HY_ER+_ER-
ACAAAGGTCACTTTAC-1	Immature_BC
ACAAAGGTCATTAGGC-1	LC_ER+
ACAAAGGTCCTTGCGT-1	HY_ER+_ER-
ACAAAGGTCGCTCCAT-1	LC_ER-
ACAACAACAGCCTGCA-1	LC_ER-
ACAACAACATTGTTGG-1	LC_ER+
ACAACACTCATGCTCC-1	LC_ER-
ACAACACTCCCTTGCG-1	LC_ER+
ACAACACTCTTGATGA-1	LC_ER+
ACAACACTCTTTGTAC-1	LC_ER+
ACAACAGAGCATGACT-1	LC_ER+
ACAACAGAGGAGGCAT-1	LC_ER+
ACACCTTGTAAAGCAA-1	LC_ER+
ACACCTTGTACCAGGT-1	LC_ER+
ACACCTTGTATTACCC-1	LC_ER-
ACACCTTGTCAAAGAA-1	LC_ER-
ACACGGACAACTAACT-1	LC_ER-
ACACGGACACAACCTA-1	LC_ER-
ACACGGACAGCTACGT-1	LC_ER-
ACACGGACATAATGAG-1	LC_ER-
ACACTAATCAATCTCT-1	LC_ER-
ACACTAATCCTGGTCT-1	LC_ER+
ACACTAATCGCTAGAT-1	LC_ER-
ACACTAATCGGGCCAT-1	LC_ER-
ACACTAATCGTAATCA-1	LC_ER-
ACACTAGGTGATGATT-1	LC_ER+
ACACTAGGTGCATTAG-1	LC_ER-
ACACTAGGTGTCCTGC-1	LC_ER-
ACACTAGGTTAACGAT-1	LC_ER-
ACACTAGGTTAATGCG-1	LC_ER+
ACACTTAAGAGGATAT-1	LC_ER+
ACACTTAAGCAAGGGT-1	LC_ER-
ACACTTAAGGTCGAGG-1	LC_ER+
ACACTTAAGTGCTGTG-1	LC_ER+
ACACTTGCAAACATAG-1	Immature_BC
ACACTTGCAATTGCGC-1	LC_ER+
ACACTTGCACTTGTTC-1	Immature_BC
ACACTTGCAGGAAGCC-1	LC_ER-
ACACTTGCATAGCTGC-1	LC_ER-
ACACTTGCATGAATAG-1	LC_ER+
ACACTTGCATTAAGTC-1	LC_ER-
ACAGCCGGTAACCTAG-1	LC_ER-
ACAGCCGGTAATCGCA-1	Immature_BC
ACAGCCGGTGCTAGAC-1	LC_ER+
ACAGCCGGTTAACGAT-1	LC_ER+
ACAGCGCTCTTAGCCC-1	LC_ER+
ACAGCGCTCTTGCAGG-1	HY_ER+_ER-
ACAGGAATCCTTGCGT-1	LC_ER+
ACAGGCTGTACGTTTC-1	LC_ER-
ACAGGCTGTCAACAAT-1	Immature_BC
ACAGGCTGTCACCAAA-1	Immature_BC
ACAGGTAAGCGGATAA-1	HY_ER+_ER-
ACAGGTAAGCTTACTT-1	HY_ER+_ER-
ACAGGTAAGGGTCTAT-1	Immature_BC
ACAGGTAAGTAATCCA-1	LC_ER+
ACAGTATGTCAAAGAA-1	LC_ER-
ACAGTATGTGAGACTC-1	LC_ER+
ACAGTATGTTGCATCT-1	LC_ER+
ACAGTATGTTTGGTTC-1	Immature_BC
ACATAGCTCAAGCTTA-1	LC_ER-
ACATAGCTCATGACCG-1	LC_ER+
ACATAGCTCGCACAAT-1	LC_ER+
ACATCAATCAAAGGCA-1	LC_ER+
ACATCAATCTAATTGG-1	LC_ER-
ACATCATCAAGGATTA-1	LC_ER+
ACATCATCAGCCTGCA-1	Immature_BC
ACATCATCAGCTTAAT-1	LC_ER-
ACATCATCATAATTGC-1	Immature_BC
ACATTAGTCCAGCACA-1	LC_ER-
ACATTAGTCGAGGAAC-1	LC_ER-
ACATTGCAGCATGTCG-1	LC_ER-
ACATTGCAGCGATACT-1	LC_ER-
ACATTGCAGGCGGGTA-1	LC_ER+
ACATTGCAGTCTGGGC-1	LC_ER+
ACCAAACTCCATTACT-1	LC_ER+
ACCAAACTCCCAGTAG-1	LC_ER+
ACCAAACTCGTAACGT-1	LC_ER-
ACCAAGCGTACTGATG-1	HY_ER+_ER-
ACCAAGCGTGAGCAAG-1	LC_ER+
ACCAAGCGTTGGGTTA-1	LC_ER+
ACCAAGTTCATGTGGT-1	LC_ER+
ACCAAGTTCGCAAACT-1	LC_ER+
ACCAATATCGGTAACT-1	LC_ER+
ACCAATATCGGTACGC-1	LC_ER-
ACCACACCAATTAAGG-1	LC_ER-
ACCACACCAATTGAGA-1	LC_ER+
ACCACACCAGCAAGGC-1	LC_ER+
ACCACACCAGCCTAAC-1	LC_ER+
ACCACACCATCCCGCT-1	LC_ER+
ACCACACCATGATTGT-1	LC_ER+
ACCACATAGTAGCGCC-1	LC_ER-
ACCACATAGTCACCTC-1	LC_ER+
ACCACATAGTGAGGTA-1	LC_ER-
ACCACATAGTGCTGTG-1	LC_ER-
ACCACATAGTTCCCAC-1	LC_ER+
ACCAGCTCAACAGGTG-1	LC_ER+
ACCAGCTCATAAAGCA-1	HY_ER+_ER-
ACCAGGACACATACTG-1	LC_ER+
ACCAGGACATATAACC-1	LC_ER+
ACCAGGACATGTCAAT-1	LC_ER-
ACCAGGCTCACAGGAA-1	LC_ER-
ACCAGGCTCACTAATG-1	LC_ER-
ACCAGGCTCCTGAGTG-1	LC_ER-
ACCAGGCTCGCCTAAG-1	HY_ER+_ER-
ACCAGGCTCTTTGAGA-1	Immature_BC
ACCAGGGAGACACCGC-1	LC_ER+
ACCAGGGAGCTTTGTT-1	LC_ER-
ACCAGGGAGTGGACAA-1	LC_ER+
ACCATAATCAAGCGCC-1	LC_ER-
ACCATAATCCTTGCAC-1	LC_ER-
ACCATAATCGCTAGAT-1	Immature_BC
ACCATTAAGGGCTAAA-1	LC_ER+
ACCATTAAGTAAAGGT-1	LC_ER-
ACCCAACCACCAACCG-1	LC_ER-
ACCCAACCATTAGGTT-1	Immature_BC
ACCCAGGGTTAACAGT-1	Immature_BC
ACCCAGGGTTATCGAG-1	LC_ER+
ACCCAGGGTTCAAGCA-1	LC_ER+
ACCCGCTGTGATCAGC-1	LC_ER+
ACCCGGTAGCACAGAA-1	LC_ER+
ACCCGGTAGCATTATG-1	LC_ER-
ACCCGGTAGCTTACTT-1	LC_ER+
ACCCGGTAGCTTAGTA-1	LC_ER-
ACCCGGTAGGACGTAA-1	LC_ER+
ACCCGGTAGGACTTAC-1	LC_ER+
ACCCGGTAGGTGCTGC-1	LC_ER+
ACCCGGTAGTTAGCTA-1	Immature_BC
ACCCGTAAGGACAATG-1	LC_ER-
ACCCGTAAGGTAAGCA-1	LC_ER+
ACCCTCCCAATAATCC-1	LC_ER+
ACCCTCCCAGCTCATA-1	LC_ER+
ACCCTGTTCATAATCG-1	LC_ER+
ACCCTGTTCCCATAAA-1	LC_ER+
ACCCTGTTCCTTCGTA-1	LC_ER-
ACCCTGTTCGGTCAAT-1	Immature_BC
ACCGAAGCAACCCTAA-1	LC_ER+
ACCGAAGCACTTAACG-1	LC_ER+
ACCGAAGCATGAGCAG-1	Immature_BC
ACCGCAATCAAAGGCA-1	LC_ER+
ACCGCAATCATTGTCT-1	LC_ER-
ACCGGCTAGCATGCAT-1	LC_ER-
ACCGGCTAGGAACGCG-1	LC_ER-
ACCGGTTCAAACAACA-1	LC_ER-
ACCGGTTCAAAGCGCA-1	LC_ER+
ACCGGTTCAACACTTG-1	LC_ER+
ACCGGTTCAATAGTCT-1	LC_ER+
ACCGGTTCACTTGTTC-1	LC_ER+
ACCGGTTCAGCATGGA-1	LC_ER+
ACCTAAATCAGCACCA-1	LC_ER-
ACCTAAATCATGGCCA-1	LC_ER-
ACCTAAATCATTGCAA-1	LC_ER+
ACCTAAATCGATATTG-1	Immature_BC
ACCTAAATCGCAAACT-1	LC_ER-
ACCTAAATCGTTACAA-1	LC_ER+
ACCTAAGGTACCAGGT-1	LC_ER+
ACCTAAGGTTTATTCG-1	LC_ER-
ACCTACCTCGTTTCTG-1	LC_ER+
ACCTACCTCTTGACCC-1	LC_ER-
ACCTCACTCCTAATAG-1	Immature_BC
ACCTCACTCGTAACGT-1	Immature_BC
ACCTCACTCGTTTCGC-1	LC_ER+
ACCTCACTCTTAGTCT-1	LC_ER+
ACCTGGATCAGGCCTA-1	LC_ER+
ACCTGGATCCCTGACT-1	LC_ER+
ACCTGGATCCTCATGC-1	Immature_BC
ACCTGGTCAAGCCACT-1	LC_ER-
ACCTGGTCACCTGTAA-1	LC_ER-
ACCTGGTCAGGAACCA-1	LC_ER+
ACCTGGTCATTGTGGC-1	LC_ER+
ACCTGTTGTAAGGTCC-1	LC_ER-
ACCTGTTGTCTATCGT-1	LC_ER-
ACCTGTTGTTTCCTCC-1	Immature_BC
ACCTTCATCATGCATA-1	LC_ER-
ACCTTCCAGGACAATG-1	LC_ER-
ACCTTGCTCACTAATG-1	HY_BC_ER+
ACCTTGCTCGCAACAT-1	LC_ER+
ACCTTGTGTGATCATG-1	Immature_BC
ACGAAGTCAGCATGTC-1	LC_ER-
ACGAATCTCATGGTGT-1	LC_ER+
ACGAATCTCCTTAATC-1	LC_ER+
ACGAATCTCGGCCAGT-1	LC_ER-
ACGAATCTCGTACCGA-1	LC_ER+
ACGAATCTCTAAGGAG-1	LC_ER+
ACGAATCTCTCCTCTT-1	LC_ER+
ACGACAAAGAGGCTAA-1	LC_ER+
ACGACTTAGGGCTTAT-1	HY_BC_ER+
ACGAGTAAGACTTACA-1	LC_ER+
ACGAGTAAGCATCCAG-1	LC_ER+
ACGAGTAAGGCGCACT-1	HY_BC_ER+
ACGAGTAAGTTATGTG-1	LC_ER-
ACGATTCAGAGGAAGG-1	LC_ER+
ACGATTCAGCGCTCAA-1	LC_ER+
ACGATTCAGGAGCAAC-1	LC_ER-
ACGCAAGCACCTCAGG-1	LC_ER+
ACGCAAGCAGACAAAC-1	HY_ER+_ER-
ACGCAAGCAGCTAACC-1	LC_ER+
ACGCAAGCAGGAACTG-1	LC_ER-
ACGCAAGCAGGCGAGT-1	LC_ER-
ACGCAAGCATTGCGTA-1	LC_ER-
ACGCACGGTTAAGGTT-1	LC_ER-
ACGCACGGTTCCTGAT-1	LC_ER-
ACGCACGGTTTAGCTC-1	LC_ER+
ACGCCACAGTAGGATG-1	LC_ER-
ACGCCACAGTCATGCG-1	LC_ER+
ACGCCTTTCACAGCCA-1	LC_ER+
ACGCCTTTCATAACTG-1	LC_ER-
ACGCCTTTCCCTCACG-1	LC_ER+
ACGCCTTTCCGCCAAA-1	LC_ER+
ACGCCTTTCCTCCCTC-1	LC_ER+
ACGCCTTTCCTTGAGG-1	Immature_BC
ACGCCTTTCTTAAGTG-1	Immature_BC
ACGCCTTTCTTGCAAA-1	LC_ER-
ACGCTTGAGCACAGAA-1	HY_ER+_ER-
ACGCTTGAGCATGCAT-1	LC_ER-
ACGCTTGAGCGATAGA-1	LC_ER+
ACGCTTGAGGGACGCA-1	HY_ER+_ER-
ACGCTTGAGGTAACGA-1	LC_ER+
ACGCTTGAGTTCCTGC-1	LC_ER-
ACGGGAAGTAACGAGG-1	LC_ER+
ACGGGAAGTACGCGCA-1	LC_ER+
ACGGGAAGTATACTGG-1	LC_ER+
ACGGGAAGTCATCATC-1	LC_ER-
ACGGGAAGTGCCGCAA-1	LC_ER+
ACGGGAAGTGTTGTAG-1	LC_ER-
ACGGTACGTATTGTGG-1	LC_ER-
ACGGTACGTCCAAATG-1	LC_ER-
ACGGTACGTGTGAGGA-1	LC_ER+
ACGGTACGTTATAGCG-1	LC_ER+
ACGGTTAGTGGATTAT-1	LC_ER-
ACGGTTAGTTATCGAG-1	Immature_BC
ACGGTTTAGCCTGTGA-1	LC_ER-
ACGTACCCAATAGTCT-1	LC_ER+
ACGTACCCAGGTTAAA-1	Immature_BC
ACGTACCCATAAAGCA-1	LC_ER-
ACGTCAAGTCTTACTA-1	LC_ER-
ACGTCAAGTGTTGCTT-1	LC_ER-
ACGTCAAGTTAACGAT-1	LC_ER+
ACGTCAAGTTGCTGGG-1	LC_ER+
ACGTCCAAGAATCTCA-1	LC_ER-
ACGTCCAAGCACCACA-1	HY_ER+_ER-
ACGTCCAAGCGAGGTG-1	LC_ER-
ACGTCCAAGGAGGCAT-1	LC_ER-
ACGTCCAAGGTCCGTA-1	LC_ER+
ACGTCCAAGGTCCTAG-1	LC_ER+
ACGTCCAAGGTTACGT-1	LC_ER+
ACGTCCAAGTTAACCA-1	Prolif
ACGTCCTTCACTAGGT-1	LC_ER-
ACGTCCTTCCTCACAC-1	LC_ER-
ACGTCCTTCTTGCATT-1	Prolif
ACGTTACAGCATTTCT-1	LC_ER+
ACGTTACAGCTTTGTT-1	LC_ER+
ACGTTACAGGCCAATT-1	LC_ER+
ACGTTACAGGTCTTGG-1	LC_ER+
ACGTTGTAGCGAAGTA-1	LC_ER+
ACGTTGTAGCTGGCTA-1	HY_ER+_ER-
ACGTTGTAGGAGCAAC-1	LC_ER+
ACGTTGTAGTAAGTCC-1	Immature_BC
ACGTTGTAGTGAACAG-1	LC_ER-
ACTAAAGCAAGGCCAA-1	LC_ER+
ACTAAAGCACCCACAG-1	LC_ER+
ACTAAAGCAGCATGTC-1	LC_ER-
ACTAACCAGCTGGCTA-1	LC_ER+
ACTAACCAGCTTAGTA-1	LC_ER-
ACTAACCAGGGATGAC-1	Immature_BC
ACTAACGGTAACGTGC-1	LC_ER+
ACTAACGGTTGCAATG-1	LC_ER-
ACTAACTCAAACGGGC-1	LC_ER-
ACTAACTCACCAACCG-1	LC_ER+
ACTAACTCAGCATTAT-1	Immature_BC
ACTAACTCAGGTATTT-1	LC_ER+
ACTAACTCATTAGCCA-1	LC_ER-
ACTAATCCAACTAGGG-1	LC_ER-
ACTAATCCATGAATCT-1	LC_ER+
ACTAGGCGTAACAGGG-1	HY_ER+_ER-
ACTAGGCGTAGGTTAT-1	Immature_BC
ACTAGGCGTAGGTTTG-1	HY_ER+_ER-
ACTAGGCGTTGTGATG-1	Immature_BC
ACTATCCGTAACCTAG-1	LC_ER-
ACTATCCGTCAAAGGG-1	Immature_BC
ACTATCCGTGACATAT-1	Immature_BC
ACTATCCGTGGAAGGC-1	HY_ER+_ER-
ACTATCCGTTAGAGGG-1	LC_ER+
ACTATCCGTTCCAGGG-1	LC_ER+
ACTATGTCAAATATCC-1	Immature_BC
ACTATGTCAAATTGCT-1	HY_ER+_ER-
ACTATGTCAAGACTCC-1	LC_ER+
ACTCACCTCACTCAAA-1	LC_ER-
ACTCACCTCGATCAGT-1	HY_ER+_ER-
ACTCACTGTTACTTCA-1	LC_ER-
ACTCAGTAGAATGACG-1	HY_ER+_ER-
ACTCAGTAGCATGCAT-1	Immature_BC
ACTCAGTAGCCACATG-1	HY_ER+_ER-
ACTCAGTAGGGCCATC-1	Immature_BC
ACTCAGTAGGGCTAAA-1	LC_ER+
ACTCAGTAGTAACCCG-1	LC_ER-
ACTCCTCAGCCGCAGT-1	LC_ER+
ACTCCTCAGGTATTGC-1	LC_ER+
ACTCCTCAGTAGCGCC-1	LC_ER-
ACTCCTCAGTTCCTGC-1	LC_ER-
ACTCGCGCACAAAGCG-1	Immature_BC
ACTCGCGCACATTAAC-1	LC_ER-
ACTCGCGCAGTAAAGC-1	LC_ER+
ACTCGCTTCAAGTGAG-1	Immature_BC
ACTCGCTTCCATTACT-1	LC_ER-
ACTCGCTTCCTCACTA-1	LC_ER-
ACTCGCTTCGCTAAAC-1	HY_ER+_ER-
ACTGAAACAACTCGCG-1	LC_ER-
ACTGAAACAAGCTAAA-1	LC_ER+
ACTGAAACAGTAATAG-1	Immature_BC
ACTGAATGTCCACAAA-1	Immature_BC
ACTGAATGTTAGAGGG-1	LC_ER+
ACTTACAAGCGAGTAA-1	Prolif
ACTTACTTCCGTAAAC-1	LC_ER-
ACTTACTTCCTCCATA-1	LC_ER+
ACTTACTTCCTTCGTA-1	LC_ER+
ACTTACTTCTAGCGTG-1	LC_ER-
ACTTACTTCTTGGACG-1	LC_ER+
ACTTAGGGTAAAGCGG-1	LC_ER+
ACTTAGGGTAACTACG-1	LC_ER+
ACTTAGGGTCATCATC-1	LC_ER-
ACTTAGGGTGCGCAAT-1	LC_ER+
ACTTAGGGTGCTCCAC-1	LC_ER+
ACTTAGGGTTCACCAT-1	LC_ER+
ACTTAGGGTTTAACGG-1	HY_ER+_ER-
ACTTAGTCAAACCCTA-1	LC_ER+
ACTTAGTCAAAGCTCC-1	HY_ER+_ER-
ACTTAGTCACAGGAAT-1	LC_ER-
ACTTATCTCATGAAGG-1	LC_ER+
ACTTATCTCATGTTTC-1	LC_ER-
ACTTATCTCCACAATA-1	LC_ER-
ACTTATCTCCCTTGCG-1	LC_ER+
ACTTATCTCGAGGAAC-1	LC_ER-
ACTTATCTCTAACCAA-1	LC_ER-
ACTTATGAGACAAAGT-1	Immature_BC
ACTTATGAGTTATTCC-1	LC_ER-
ACTTCGCTCAAGGACA-1	Immature_BC
ACTTCGCTCACCTGTC-1	LC_ER+
ACTTCGCTCCAACTGG-1	LC_ER-
ACTTCGCTCCGCAAGC-1	LC_ER+
ACTTCGCTCGTTTCCA-1	LC_ER-
ACTTCGCTCTAATTGG-1	LC_ER-
ACTTCGCTCTCACATT-1	LC_ER+
ACTTCGCTCTCACTAT-1	LC_ER-
ACTTGAATCAATAGCC-1	LC_ER-
ACTTGAATCACAGGAA-1	LC_ER-
ACTTGAATCAGCCAAT-1	LC_ER-
ACTTGAATCCAGGGAG-1	Immature_BC
ACTTGAATCCTCATCA-1	LC_ER+
ACTTGAATCCTTGCGT-1	LC_ER-
ACTTGAATCGAAGTAG-1	Immature_BC
ACTTGCACAGATAGAC-1	LC_ER+
ACTTGCACATTGTGGC-1	Immature_BC
ACTTGTAAGAGGATAT-1	LC_ER-
ACTTGTAAGCAAGATG-1	Immature_BC
ACTTGTAAGCAAGGAC-1	LC_ER-
ACTTGTAAGCTATATG-1	Immature_BC
ACTTGTAAGGCAACAA-1	LC_ER+
ACTTGTCGTGTTGTAG-1	LC_ER+
ACTTGTCGTTGTCCAT-1	LC_ER+
ACTTGTCGTTTGACCT-1	LC_ER-
ACTTTGTTCCATTACT-1	LC_ER-
ACTTTGTTCCCGCAAA-1	HY_ER+_ER-
ACTTTGTTCCTTTACG-1	Immature_BC
AGAAACCCACTTAACG-1	LC_ER-
AGAAACCCAGCATGGA-1	LC_ER+
AGAAACCCAGTTAAAG-1	LC_ER-
AGAAACCCATGTTGGC-1	Immature_BC
AGAAACTAGAGGCTAA-1	LC_ER+
AGAAACTAGCTACTGG-1	Immature_BC
AGAAACTAGGTCCTGA-1	LC_ER+
AGAAAGGCAAGTCGCT-1	HY_BC_ER+
AGAAAGGCAATAGCAA-1	Immature_BC
AGAAAGGCAGGCTTCG-1	LC_ER+
AGAAAGGCAGTTTGGC-1	LC_ER-
AGAACAAGTATTGTCC-1	LC_ER+
AGAACAAGTTATCCGT-1	LC_ER-
AGAACAAGTTGGATCA-1	LC_ER-
AGAACCAAGCACGATT-1	LC_ER+
AGAACCAAGCTAATCA-1	LC_ER-
AGAACCAAGCTCGCTT-1	LC_ER+
AGAACCAAGGATCCGC-1	LC_ER+
AGAACCAAGGCCTGGT-1	LC_ER-
AGAACCAAGGCCTTAG-1	Immature_BC
AGAACCAAGTGAACAG-1	Immature_BC
AGAACCGCAACACTTG-1	LC_ER+
AGAACCGCAAGCGAGC-1	LC_ER-
AGAACCGCACGTTACA-1	LC_ER+
AGAACCGCATCATGTG-1	HY_ER+_ER-
AGAAGGTGTCACCTAT-1	LC_ER-
AGAAGGTGTCCTAATC-1	LC_ER-
AGAAGGTGTTTACCGT-1	LC_ER-
AGAATCGAGAGAGGAG-1	LC_ER-
AGAATCGAGCACAGAA-1	Immature_BC
AGAATCGAGCTGAGGG-1	LC_ER-
AGAATCTGTCATGAGC-1	LC_ER+
AGAATCTGTGGAGCAA-1	LC_ER-
AGAATCTGTTCCAGGG-1	Immature_BC
AGACAATAGGCATGTT-1	LC_ER-
AGACAATAGGTTAGAG-1	LC_ER+
AGACACGCAAGTGTTT-1	LC_ER-
AGACACGCACCTAATG-1	LC_ER-
AGACCCGGTAATCACG-1	LC_ER+
AGACCCGGTCAATACG-1	LC_ER-
AGACCCGGTGGAAGGC-1	HY_BC_ER+
AGACCCGGTTCGCTCA-1	LC_ER-
AGACCCGGTTGAGGTC-1	LC_ER+
AGACCCGGTTGCACAA-1	LC_ER+
AGACTATGTAGTTGGC-1	LC_ER+
AGAGAAGCAACCGCCA-1	Immature_BC
AGAGAGGAGAGGCTAA-1	Immature_BC
AGAGAGGAGGCCTGGT-1	Immature_BC
AGAGAGGAGTCATCCC-1	LC_ER-
AGAGATTAGCCAGTAT-1	LC_ER-
AGAGATTAGGATTGAG-1	LC_ER+
AGAGATTAGTAATCCA-1	LC_ER+
AGAGGAACAATACTGT-1	LC_ER+
AGAGGAACAATTGACT-1	Immature_BC
AGAGGAACACACTAAT-1	LC_ER+
AGAGGAACATTATGCG-1	LC_ER+
AGAGGATGTCTAACAG-1	LC_ER-
AGAGGATGTGATGATT-1	LC_ER+
AGAGGATGTTCCAGGG-1	Immature_BC
AGAGGATGTTCCGGCT-1	HY_ER+_ER-
AGATGAAGTCTCAGCC-1	LC_ER-
AGATGAAGTGATGAGG-1	LC_ER+
AGATGAAGTGTGAGAG-1	LC_ER-
AGATGAAGTTGTAAAC-1	HY_ER+_ER-
AGATGCTTCACGCCAA-1	HY_ER+_ER-
AGATGCTTCCTACCTA-1	LC_ER-
AGATGCTTCGGCCAGT-1	LC_ER+
AGATGCTTCGTTAGCG-1	LC_ER+
AGATGCTTCTCGACCT-1	LC_ER-
AGCAAATAGAAGCTAG-1	LC_ER+
AGCAAATAGGCGGATG-1	LC_ER+
AGCAAATAGTAACGGA-1	LC_ER+
AGCAACAAGCACAGGG-1	LC_ER+
AGCAACAAGCAGGTTT-1	LC_ER-
AGCAACAAGTTTGTCT-1	Immature_BC
AGCAAGGGTGCAATGC-1	LC_ER-
AGCAAGGGTGTTTGCT-1	LC_ER+
AGCAAGGGTTCCTGAT-1	LC_ER+
AGCAAGGGTTGTGATG-1	LC_ER-
AGCAAGGGTTTGTGGA-1	LC_ER-
AGCAATACAAGGTGGC-1	Immature_BC
AGCAATACAATTGAAG-1	LC_ER-
AGCAATTGTAAGCTTG-1	LC_ER-
AGCAATTGTGCTGTAA-1	LC_ER-
AGCAATTGTTCGCTTG-1	LC_ER+
AGCAATTGTTGCAGTA-1	HY_ER+_ER-
AGCACAGCAATTGAAG-1	LC_ER+
AGCACAGCACGTGCTG-1	LC_ER+
AGCACAGCAGCTAACC-1	LC_ER-
AGCACTAGTCAAGTGC-1	LC_ER+
AGCACTAGTGACCTGG-1	LC_ER-
AGCACTAGTGTTTCAC-1	LC_ER-
AGCACTTAGAGAGGAG-1	LC_ER+
AGCACTTAGCGAAGTA-1	LC_ER+
AGCACTTAGCTTACTT-1	LC_ER+
AGCACTTAGGTCAAAG-1	LC_ER-
AGCACTTAGTAGCTTA-1	LC_ER+
AGCAGGTAGAAAGCAT-1	LC_ER-
AGCAGGTAGAGGAAGG-1	LC_ER-
AGCAGGTAGGTTAGCT-1	LC_ER+
AGCATTTCATTGTGGC-1	HY_BC_ER+
AGCCAGTGTCATTACC-1	LC_ER-
AGCCAGTGTCTCACTG-1	Immature_BC
AGCCAGTGTTAGGCGT-1	LC_ER+
AGCCAGTGTTAGTACG-1	LC_ER+
AGCCGCTAGACCATAC-1	LC_ER+
AGCCGCTAGCTGGCTA-1	Prolif
AGCCGCTAGGAAGTAT-1	LC_ER+
AGCCGCTAGGTCAAAG-1	LC_ER-
AGCCGCTAGTACCGCA-1	LC_ER+
AGCCGGTTCCCTCAAC-1	LC_ER+
AGCCGGTTCGGTTCCT-1	HY_ER+_ER-
AGCCGGTTCGTGCTAG-1	LC_ER-
AGCCGGTTCTAATCTC-1	LC_ER+
AGCCGGTTCTGTGCAG-1	HY_ER+_ER-
AGCCTAAGTGATGATT-1	LC_ER+
AGCCTAAGTGTTTCAC-1	LC_ER+
AGCCTAGTCAATCTCT-1	LC_ER+
AGCCTAGTCATGAAGG-1	LC_ER+
AGCCTAGTCCTCACAC-1	LC_ER-
AGCCTAGTCTAACCTT-1	LC_ER-
AGCCTCCGTATTGGAT-1	LC_ER-
AGCCTCCGTGAGCGAA-1	LC_ER-
AGCCTCCGTGAGGTGA-1	LC_ER-
AGCCTCCGTGGTTCTT-1	LC_ER-
AGCCTCCGTTAGTGAT-1	LC_ER-
AGCCTCCGTTGAATCG-1	HY_ER+_ER-
AGCCTCCGTTGCGGAT-1	LC_ER-
AGCCTGGGTGTAACCA-1	LC_ER-
AGCCTGGGTGTTTGCT-1	LC_ER+
AGCGATTTCCTCCCTC-1	LC_ER+
AGCGATTTCGAGGAAC-1	LC_ER-
AGCGATTTCTTTAAGG-1	LC_ER-
AGCGCCTAGACTAAGG-1	LC_ER+
AGCGCCTAGGGTGAAC-1	LC_ER-
AGCGCCTAGTAACGGA-1	Immature_BC
AGCGCTCAGCTCGCTT-1	Immature_BC
AGCGCTCAGTAACGGA-1	LC_ER+
AGCGCTCAGTTCCTGC-1	LC_ER-
AGCGGACCACCTCACC-1	Immature_BC
AGCGGACCACGTGCTG-1	LC_ER-
AGCGGATAGACTATTG-1	LC_ER-
AGCGGATAGGACAACA-1	Immature_BC
AGCGGATAGTTATCTC-1	Immature_BC
AGCGGATAGTTGGCCA-1	LC_ER+
AGCTAAACAACATAAG-1	LC_ER+
AGCTAAACAGTATGTT-1	Immature_BC
AGCTAAACAGTTGCGT-1	LC_ER-
AGCTAACTCCTCACTA-1	LC_ER-
AGCTAACTCGCAGGCT-1	Immature_BC
AGCTAACTCGCTATAA-1	LC_ER-
AGCTAACTCGTTTCCA-1	LC_ER+
AGCTAACTCTTAGGAC-1	LC_ER+
AGCTACGTCAAGCTTA-1	LC_ER-
AGCTACGTCATTATGG-1	LC_ER+
AGCTACGTCATTTGTC-1	HY_ER+_ER-
AGCTACGTCCCTGACT-1	LC_ER+
AGCTACGTCCGGGACT-1	LC_ER+
AGCTACGTCCGTGACA-1	LC_ER-
AGCTACTAGGGATGAC-1	LC_ER-
AGCTACTAGTAGAGGC-1	LC_ER-
AGCTAGTTCAAACTCA-1	LC_ER+
AGCTAGTTCGGTTAGT-1	Immature_BC
AGCTATATCAAGCTTA-1	Immature_BC
AGCTATATCCCGAACA-1	LC_ER+
AGCTATATCGGTTACG-1	LC_ER+
AGCTCATAGGAATAAC-1	LC_ER+
AGCTCATAGGTAAGGC-1	LC_ER+
AGCTCATAGTAAGGGC-1	LC_ER+
AGCTGCTCACGTAATT-1	LC_ER+
AGCTGCTCACTAGGTC-1	LC_ER-
AGCTTAATCGCAATCG-1	LC_ER+
AGCTTAATCTAGCGTG-1	LC_ER+
AGCTTAATCTCGACCT-1	LC_ER+
AGCTTCCTCCCAGTAG-1	LC_ER-
AGCTTCCTCCTTCTAG-1	LC_ER+
AGCTTCCTCGCAACAT-1	LC_ER+
AGCTTGGTCATAACGC-1	LC_ER-
AGCTTGGTCCTAAGAC-1	LC_ER+
AGCTTGGTCGATTTGA-1	LC_ER+
AGCTTGGTCTCGACCT-1	LC_ER+
AGCTTTAAGCGGCTGT-1	LC_ER+
AGCTTTAAGTAGCGCC-1	LC_ER-
AGGAAACGTCCTAATC-1	LC_ER-
AGGAAACGTCCTTCAG-1	LC_ER+
AGGAAACGTGGTGAGA-1	LC_ER+
AGGAAACGTTTGGCGG-1	LC_ER-
AGGAACCAGCTTTGGG-1	LC_ER+
AGGAACCAGGCTAGAA-1	LC_ER-
AGGAACCAGGGCCATC-1	LC_ER+
AGGAACCAGTCATTTC-1	LC_ER+
AGGACGTAGGAACACA-1	LC_ER-
AGGACGTAGGAACCGG-1	LC_ER-
AGGACGTAGGCCTTAG-1	LC_ER+
AGGACGTAGGCTTAAC-1	LC_ER+
AGGACGTAGGGTGAAC-1	LC_ER-
AGGACGTAGTGTTGTA-1	Immature_BC
AGGACTAAGCATGACT-1	LC_ER+
AGGACTAAGGTTTGAC-1	HY_ER+_ER-
AGGACTAAGTAAGAAC-1	LC_ER+
AGGACTAAGTTAGTTG-1	LC_ER+
AGGAGCTAGGCTACTG-1	Immature_BC
AGGAGCTAGGCTATGT-1	LC_ER+
AGGAGCTAGGTGAAGC-1	Immature_BC
AGGAGCTAGTTTCCGC-1	LC_ER+
AGGATATAGGACCTTG-1	LC_ER-
AGGATATAGGCTATGT-1	LC_ER+
AGGATATAGGTAGCTT-1	LC_ER-
AGGATATAGTCTCACC-1	LC_ER-
AGGATCCGTAGCAGCT-1	LC_ER+
AGGATCCGTGTCCTGC-1	LC_ER+
AGGATCCGTGTGAGAG-1	HY_ER+_ER-
AGGATCCGTTGCTTCG-1	HY_BC_ER+
AGGATGCAGATTGAGG-1	LC_ER-
AGGATGCAGCCTAACG-1	HY_ER+_ER-
AGGATGCAGGAGTAAT-1	HY_ER+_ER-
AGGATGCAGTGAGGGT-1	LC_ER+
AGGATGTCAAATTCGT-1	LC_ER-
AGGATGTCAGGATGGC-1	LC_ER-
AGGATGTCATAATTGC-1	LC_ER-
AGGATGTCATAGTCAT-1	LC_ER+
AGGATTGAGTAGCGCC-1	HY_ER+_ER-
AGGATTGAGTGAGCAA-1	LC_ER+
AGGATTGAGTTAGACC-1	LC_ER+
AGGCAATCATGCTTAG-1	LC_ER-
AGGCAGGTCCCGTTTA-1	LC_ER-
AGGCAGGTCCCTCTAA-1	LC_ER+
AGGCAGGTCCGCAACA-1	LC_ER+
AGGCAGGTCTTAGGGT-1	HY_ER+_ER-
AGGCCCAGTAAAGCGG-1	Immature_BC
AGGCCCAGTGCTTAGA-1	LC_ER-
AGGCCCAGTGGATGTC-1	LC_ER-
AGGCCCAGTGTTGTGA-1	LC_ER-
AGGCCCAGTGTTTGCT-1	LC_ER+
AGGCCCAGTTGTTGTC-1	LC_ER+
AGGCGGATCACCATTT-1	LC_ER+
AGGCGGATCATTGTCT-1	LC_ER-
AGGCGGATCTCCATAT-1	LC_ER+
AGGCTAAAGTATTGTG-1	LC_ER-
AGGCTAGCAAACGGGC-1	LC_ER-
AGGCTAGCAGGAACCA-1	LC_ER+
AGGCTAGCATCCATCT-1	LC_ER+
AGGGCCTTCGGGACTC-1	LC_ER+
AGGGCCTTCGTTCACC-1	Immature_BC
AGGGCCTTCTTAGGGT-1	LC_ER-
AGGGCTACAAGGTCCT-1	LC_ER-
AGGGCTACAGCACGAA-1	LC_ER+
AGGGTTGCAGTTAGCC-1	LC_ER+
AGGGTTGCATCCTGAA-1	LC_ER+
AGGTAACCAGGCCTTG-1	LC_ER-
AGGTAACCAGTTAAAG-1	LC_ER+
AGGTACGCAGAGGCTA-1	LC_ER-
AGGTACGCAGGCTACT-1	LC_ER+
AGGTACGCAGTATGTT-1	LC_ER-
AGGTACGCATATTGAC-1	LC_ER+
AGGTACGCATCCTAGA-1	HY_BC_ER+
AGGTATTGTAATGGCC-1	LC_ER-
AGGTATTGTGCTCACC-1	LC_ER+
AGGTATTGTGGATTCA-1	LC_ER-
AGGTATTGTGTGCAAC-1	HY_ER+_ER-
AGGTATTGTTAAATGC-1	HY_ER+_ER-
AGGTATTGTTAGGACC-1	LC_ER+
AGGTCAAAGCACAGCC-1	LC_ER+
AGGTCAAAGCACTAAC-1	Immature_BC
AGGTCAAAGGCTAGAA-1	LC_ER-
AGGTCAAAGTACCGCA-1	Immature_BC
AGGTCAAAGTCTGGGC-1	LC_ER+
AGGTCATTCAGGCTAT-1	Immature_BC
AGGTCATTCATAACCA-1	Immature_BC
AGGTCATTCCCATAGG-1	LC_ER+
AGGTCATTCGTACCGA-1	LC_ER-
AGGTCCGGTAATGACT-1	LC_ER+
AGGTCCGGTATTGTCC-1	LC_ER-
AGGTCCGGTCAAGTGC-1	LC_ER+
AGGTCCGGTGCTAGCG-1	HY_ER+_ER-
AGGTCCGGTGTGCAAC-1	LC_ER-
AGGTCTTAGATGGAGC-1	LC_ER-
AGGTCTTAGCCGGTAC-1	LC_ER-
AGGTCTTAGGCGAATA-1	HY_ER+_ER-
AGGTCTTAGTAAACCC-1	LC_ER+
AGGTCTTAGTGAGAGC-1	LC_ER-
AGGTGAATCACAGCGC-1	LC_ER-
AGGTGAATCCGGTTGA-1	HY_BC_ER+
AGGTGAGGTCTCACTG-1	LC_ER-
AGGTGAGGTGATCATG-1	LC_ER-
AGGTTAACAAACCTAT-1	HY_ER+_ER-
AGGTTAACAAACGCGA-1	LC_ER+
AGGTTAACAAGGATTA-1	LC_ER+
AGGTTAACAGAACCGA-1	LC_ER+
AGGTTAACAGCAGGTA-1	LC_ER-
AGGTTAACAGGTTAAA-1	LC_ER+
AGGTTAACATTTGCTC-1	LC_ER-
AGGTTACTCATTGCGG-1	LC_ER-
AGGTTACTCCAGCACA-1	LC_ER+
AGGTTAGAGCCTAATA-1	Immature_BC
AGGTTAGAGCGCAATT-1	LC_ER-
AGGTTAGAGGAATAAC-1	LC_ER+
AGGTTAGAGGATTTGC-1	HY_ER+_ER-
AGGTTAGAGGCATGAA-1	LC_ER+
AGGTTAGAGGCTGTCA-1	LC_ER+
AGGTTAGAGTAACGGA-1	LC_ER-
AGGTTAGAGTGGCGGA-1	LC_ER+
AGGTTGCGTGCGCGTA-1	LC_ER-
AGGTTGCGTGTTGTGA-1	LC_ER+
AGGTTGCGTTTCGCGC-1	LC_ER-
AGGTTTATCATCACTT-1	LC_ER+
AGGTTTATCCCTGGAA-1	Immature_BC
AGGTTTATCGATCAGT-1	LC_ER-
AGGTTTATCTTAGCCC-1	LC_ER-
AGGTTTGGTCCTAATC-1	LC_ER+
AGGTTTGGTTTGTTGC-1	LC_ER-
AGTAAACAGCACGATT-1	LC_ER-
AGTAAACAGCACTAAC-1	LC_ER+
AGTAAACAGCGATAAG-1	Immature_BC
AGTAAACAGGGACGCA-1	LC_ER+
AGTAACACAATATGGA-1	Immature_BC
AGTAACACACCTGCTC-1	LC_ER+
AGTAACACACGTGCTG-1	LC_ER-
AGTAACACATGCAACC-1	LC_ER-
AGTAACACATTATGAC-1	Prolif
AGTAACACATTGGGAG-1	LC_ER+
AGTAACCTCACTTTAC-1	HY_ER+_ER-
AGTAACCTCCCATAGG-1	LC_ER+
AGTAACCTCCTAGTAA-1	Immature_BC
AGTAACCTCTTAGTGA-1	Immature_BC
AGTAACCTCTTGATGA-1	LC_ER-
AGTAACGAGCACTAGT-1	LC_ER+
AGTAACGAGGCTGTGC-1	LC_ER-
AGTAACGAGTGCTGTG-1	LC_ER+
AGTAAGTAGACTAAGG-1	LC_ER+
AGTAAGTAGTGGACAA-1	LC_ER-
AGTAATCGTAACTACG-1	LC_ER+
AGTAATCGTAGCTGGT-1	LC_ER+
AGTAATCGTTAAGCCA-1	LC_ER+
AGTAATGCACTTAGGC-1	LC_ER+
AGTAATGCATTCCTCG-1	LC_ER-
AGTACGCGTACTTAGG-1	HY_ER+_ER-
AGTACGCGTGGATGTC-1	LC_ER+
AGTACGCGTGTAACCA-1	HY_ER+_ER-
AGTACGCGTTAAGTGT-1	LC_ER+
AGTAGCTTCCTCATCA-1	LC_ER+
AGTAGCTTCGTAATCA-1	LC_ER+
AGTAGCTTCTCACATT-1	LC_ER-
AGTAGGATCTCGCCTG-1	Immature_BC
AGTATAGCAATAGCCC-1	HY_ER+_ER-
AGTATAGCAGCACGTT-1	LC_ER+
AGTATAGCAGCCAGAA-1	Prolif
AGTATAGCATAGCGAG-1	LC_ER-
AGTCAAGAGCCTCTCG-1	LC_ER+
AGTCAAGAGGAGTCTT-1	LC_ER+
AGTCAAGAGGGACGCA-1	LC_ER-
AGTCAAGAGGTCCGTA-1	LC_ER+
AGTCAAGAGGTCCTGA-1	LC_ER+
AGTCAATGTGGGTACT-1	LC_ER+
AGTCAATGTTCAAGCA-1	LC_ER+
AGTCAGGCAACACCTA-1	LC_ER+
AGTCAGGCAACCTGGT-1	HY_BC_ER+
AGTCAGGCACGTAAGG-1	Immature_BC
AGTCAGGCAGAGGCTA-1	LC_ER+
AGTCAGGCAGGCTAAG-1	LC_ER+
AGTCAGGCATGGCCTG-1	HY_ER+_ER-
AGTCCTGAGGAGGACT-1	Immature_BC
AGTCCTGAGTAAACCC-1	LC_ER-
AGTCCTGAGTATTGTG-1	HY_ER+_ER-
AGTCCTGAGTGAACAG-1	LC_ER-
AGTCCTGAGTGACCTG-1	LC_ER+
AGTCCTGAGTTTAACG-1	LC_ER+
AGTCCTTGTCTTGCAT-1	LC_ER+
AGTCCTTGTTAGAGGG-1	LC_ER-
AGTCCTTGTTGAGCCG-1	LC_ER-
AGTCCTTGTTGTTGCT-1	LC_ER-
AGTCGCATCCCTCTAA-1	LC_ER+
AGTCGCATCGATTTGA-1	LC_ER+
AGTCTTGCAACATAAG-1	Immature_BC
AGTCTTGCACAAGCCT-1	LC_ER+
AGTCTTGCACGAATTT-1	Immature_BC
AGTGAACCAGGATTAA-1	LC_ER-
AGTGAACCATGTTGTG-1	LC_ER+
AGTGAACCATTAAGCT-1	Immature_BC
AGTGAACCATTAAGTC-1	LC_ER-
AGTGAGTCACCACAAC-1	LC_ER+
AGTGAGTCAGCTAACC-1	LC_ER+
AGTGAGTCATTATGAC-1	LC_ER+
AGTGATGAGCCTGACA-1	LC_ER-
AGTGATGAGCTGAGGG-1	LC_ER+
AGTGATGAGTATTGGC-1	LC_ER+
AGTGATGAGTGAGGTA-1	LC_ER+
AGTGCACGTCCTAAGA-1	LC_ER-
AGTGCACGTCGCGCAA-1	LC_ER-
AGTGCACGTGCACGCA-1	LC_ER+
AGTGCACGTTGCAGTA-1	LC_ER+
AGTGCCGGTTACTTGC-1	HY_ER+_ER-
AGTGCGGAGGCGCTTA-1	Immature_BC
AGTGCGGAGGTCGAGG-1	LC_ER+
AGTGCGGAGTTGGGCC-1	LC_ER-
AGTGGACAGGCAATAG-1	Immature_BC
AGTGGACAGTCACCTC-1	Immature_BC
AGTGGACAGTCCTTCA-1	LC_ER-
AGTGGACAGTGAGGGT-1	HY_ER+_ER-
AGTGTGGCAGACAAAC-1	LC_ER-
AGTGTGGCATCACTTC-1	LC_ER+
AGTGTTTCAAGCTAAA-1	LC_ER+
AGTGTTTCAAGGTCGA-1	LC_ER+
AGTGTTTCACCATATG-1	LC_ER-
AGTGTTTCAGTTTACG-1	LC_ER-
AGTTACATCAAGCTAC-1	LC_ER-
AGTTACATCAGGGCCT-1	LC_ER+
AGTTACATCATTAGGC-1	LC_ER+
AGTTACATCGAAGTAG-1	LC_ER-
AGTTACTCACATACTG-1	Immature_BC
AGTTACTCAGGCCAAA-1	HY_ER+_ER-
AGTTACTCATTTAAGC-1	Immature_BC
AGTTATGTCGTGCCTT-1	LC_ER-
AGTTATGTCTTAGTGA-1	LC_ER-
AGTTGCAGTAACGAGG-1	LC_ER+
AGTTGCAGTAATGACT-1	LC_ER-
AGTTGCAGTCATCCTG-1	Prolif
AGTTGCAGTTAACACG-1	LC_ER-
AGTTGCGTCATAGACC-1	LC_ER-
AGTTGCGTCCGTAAAC-1	LC_ER-
AGTTGGCGTGGTTATG-1	LC_ER-
AGTTGGCGTTTGTTGC-1	LC_ER+
AGTTTGATCGAAGTAG-1	LC_ER+
AGTTTGCAGCACAGGG-1	LC_ER+
ATAACGACAAGATTCT-1	LC_ER-
ATAACGACAATGCCCG-1	LC_ER+
ATAACGACAGTACCGT-1	LC_ER+
ATAACGACATTGTGAT-1	LC_ER+
ATAAGCCTCCTTAGGG-1	LC_ER+
ATAAGCCTCTCCATAT-1	LC_ER-
ATAAGTCGTAAATTGC-1	LC_ER+
ATAAGTCGTAATGGCC-1	LC_ER+
ATAAGTCGTGCTCCAC-1	LC_ER+
ATAATGGCAAGGAATC-1	LC_ER+
ATACCGGTCAAGTGTC-1	LC_ER-
ATACCGGTCCCATAAA-1	LC_ER-
ATACCGGTCCCGCAAA-1	LC_ER+
ATACCTGCAGAAATGC-1	LC_ER-
ATACCTGCATGTTTGG-1	LC_ER-
ATACCTGCATTCCTGT-1	LC_ER-
ATACCTGCATTGTGCA-1	LC_ER+
ATAGATGCACCTACTT-1	LC_ER-
ATAGATGCACTTAGGC-1	LC_ER+
ATAGATGCAGCCAGAA-1	LC_ER-
ATAGATGCAGGGAGGA-1	LC_ER-
ATAGATGCATCACTTC-1	Immature_BC
ATAGCATGTATTTGGG-1	LC_ER-
ATAGCATGTCATGAGC-1	LC_ER+
ATAGCATGTCGACTCC-1	LC_ER-
ATAGGTACACGTTACA-1	Immature_BC
ATAGGTACAGCAAGAT-1	LC_ER+
ATAGGTACAGGAACAT-1	LC_ER-
ATAGGTACAGTTTGGC-1	LC_ER+
ATAGGTACATCTAGCA-1	Immature_BC
ATATAGGCAGCATGGA-1	LC_ER-
ATATAGGCATAAGTTC-1	LC_ER+
ATATAGGCATAGGCGA-1	LC_ER-
ATATGCATCGCACAAT-1	LC_ER-
ATATGCATCGGTTTCC-1	LC_ER+
ATATGCTCAAAGGTAC-1	LC_ER+
ATATGGTGTGGCTTCC-1	LC_ER-
ATATGTCCACGAACAG-1	LC_ER+
ATATGTCCAGAAATGC-1	LC_ER+
ATATGTCCAGGCTACT-1	HY_ER+_ER-
ATCAAGACAAGTGTTT-1	LC_ER-
ATCAAGACACACAATT-1	LC_ER+
ATCAAGACAGCAAATA-1	LC_ER+
ATCAAGACAGTAAGTA-1	LC_ER-
ATCAAGACATAGCGAG-1	LC_ER+
ATCAAGACATGCATAT-1	Immature_BC
ATCAAGCTCCTTGCAC-1	LC_ER-
ATCAAGCTCTATCGCC-1	LC_ER+
ATCAAGCTCTCCTCAA-1	LC_ER+
ATCAATCCACCAAAGG-1	LC_ER+
ATCAATCCAGTAGGAT-1	Immature_BC
ATCACAATCAGGTTTA-1	LC_ER+
ATCACAATCTATCGCC-1	LC_ER-
ATCACACAGAGGAGGA-1	LC_ER-
ATCACCCTCATTGCAA-1	Immature_BC
ATCACCCTCGCTAAAC-1	LC_ER-
ATCACCCTCTGGCAAT-1	Immature_BC
ATCACTAAGAATGACG-1	LC_ER+
ATCACTAAGACTATTG-1	LC_ER+
ATCACTAAGGAAACTG-1	LC_ER-
ATCACTAAGGAGTCTT-1	LC_ER+
ATCAGGTTCACTCGCT-1	HY_ER+_ER-
ATCAGGTTCATAACCA-1	HY_ER+_ER-
ATCAGGTTCCTGGTCT-1	LC_ER-
ATCATCAAGCACTAAC-1	LC_ER+
ATCATCAAGCTGGAAA-1	LC_ER-
ATCATCAAGGTGTTAC-1	LC_ER-
ATCATGTCAGCTCATA-1	LC_ER+
ATCATGTCAGGGAGCT-1	LC_ER-
ATCCAACAGCATTAGC-1	LC_ER+
ATCCAACAGCATTTCT-1	LC_ER-
ATCCACCTCACCATTT-1	Immature_BC
ATCCACCTCTTGATGA-1	LC_ER+
ATCCATAAGGAGCAAC-1	LC_ER+
ATCCATAAGGCGTAAA-1	LC_ER+
ATCCATAAGGGCTAAA-1	LC_ER-
ATCCATAAGTGCACGC-1	LC_ER+
ATCCCGCGTGCAACTA-1	LC_ER-
ATCCCGCGTTAAGCTG-1	LC_ER-
ATCCGTGAGCCGCAAC-1	LC_ER-
ATCCTCATCGAGGTGG-1	LC_ER-
ATCCTCATCGTGCCTT-1	LC_ER+
ATCCTGACACAATTAC-1	Immature_BC
ATCCTGACACCTAAGC-1	LC_ER-
ATCCTGACATATAACC-1	LC_ER+
ATCCTGACATCAGCAC-1	HY_ER+_ER-
ATCCTTAGTCAATGTG-1	Immature_BC
ATCCTTAGTCATTGAG-1	LC_ER-
ATCCTTAGTGTGTGGT-1	HY_ER+_ER-
ATCGAGGCAGGCTACT-1	LC_ER+
ATCGAGGCATGTCAAT-1	LC_ER-
ATCGAGGCATTGCAGC-1	HY_ER+_ER-
ATCGCCCGTTGGATAT-1	LC_ER-
ATCGCCCGTTTAACGG-1	Immature_BC
ATCGCCCGTTTGGTTC-1	LC_ER+
ATCGCTTGTTGCATCT-1	Immature_BC
ATCGCTTGTTTCCACG-1	Immature_BC
ATCGGCCAGAGAGGAG-1	LC_ER-
ATCGGCCAGCACGATT-1	LC_ER-
ATCGGCCAGCTTTGGG-1	Immature_BC
ATCGGCCAGGCAGGTG-1	LC_ER-
ATCGGCCAGTTGGCCA-1	LC_ER+
ATCTATGAGCCTGTGA-1	LC_ER-
ATCTATGAGGCCATCA-1	LC_ER+
ATCTATGAGGGCTTTG-1	LC_ER+
ATCTATGAGTTACTTC-1	Prolif
ATCTATGAGTTTAACG-1	LC_ER-
ATCTTTGGTAAGGTTT-1	LC_ER-
ATCTTTGGTCAGGCCA-1	LC_ER-
ATCTTTGGTCATAAGT-1	Immature_BC
ATCTTTGGTTCGGTAA-1	LC_ER-
ATCTTTGGTTGTCATC-1	LC_ER-
ATGAAGCCAAAGCGCA-1	LC_ER-
ATGAAGTAGCCAAATC-1	LC_ER-
ATGAAGTAGGCATGAA-1	LC_ER-
ATGAAGTAGGTCCTGA-1	Immature_BC
ATGAAGTAGTTCCTGC-1	LC_ER+
ATGAATGCACTAGGTC-1	LC_ER+
ATGACAACAAACAACA-1	LC_ER-
ATGACAACACCTCACC-1	HY_BC_ER+
ATGACAACACGTTACA-1	HY_BC_ER+
ATGACCAGTGCCGCAA-1	LC_ER-
ATGACCAGTGCTAGAC-1	LC_ER+
ATGACGAAGATGGACA-1	Immature_BC
ATGACGAAGCTATTGA-1	LC_ER+
ATGACGAAGCTTAGTA-1	LC_ER+
ATGACGAAGGTCAAAG-1	LC_ER+
ATGACGAAGTTTGGGT-1	LC_ER+
ATGACTCAGCTTAACA-1	LC_ER-
ATGACTCAGGACCTCA-1	LC_ER+
ATGACTCAGGCGAAAC-1	Immature_BC
ATGAGCCGTCCTTCAG-1	LC_ER-
ATGAGCCGTGGCTTCC-1	LC_ER-
ATGAGCCGTGTTGCTT-1	LC_ER-
ATGAGCCGTTCTTTAG-1	LC_ER+
ATGATGACAATTTAGC-1	LC_ER-
ATGATGACACAGAACG-1	LC_ER+
ATGATGACATTCCTGT-1	LC_ER+
ATGATGGAGCGCATTG-1	LC_ER-
ATGATGGAGCTAATCA-1	LC_ER+
ATGATGGAGGCCAATT-1	LC_ER+
ATGATGGAGGGACGCA-1	LC_ER+
ATGATGGAGTTGGATC-1	LC_ER-
ATGCAAACAGTAAGTA-1	Immature_BC
ATGCAAACAGTCTAAT-1	LC_ER-
ATGCAAACATAAGTTC-1	LC_ER+
ATGCAAACATGCTTAG-1	LC_ER-
ATGCAAACATTATGCG-1	HY_ER+_ER-
ATGCAAACATTGTCAG-1	HY_ER+_ER-
ATGCAGGCAAGTAAGC-1	Immature_BC
ATGCAGGCATAATCGT-1	LC_ER+
ATGCAGGCATCCCTCA-1	LC_ER-
ATGCATTCAAACCTTG-1	LC_ER-
ATGCATTCAAAGCTAA-1	Immature_BC
ATGCATTCAATGCCTA-1	LC_ER-
ATGCATTCACCTAAGC-1	LC_ER+
ATGCATTCACGTAATT-1	LC_ER-
ATGCATTCAGCTTAAT-1	LC_ER-
ATGCGATTCATAGCCG-1	LC_ER+
ATGCGATTCATGGCCA-1	LC_ER+
ATGCGATTCATTCATC-1	LC_ER+
ATGCGATTCCGCCTAT-1	Immature_BC
ATGCGATTCCTAATTC-1	LC_ER+
ATGCGATTCGTGCCTT-1	LC_ER+
ATGCTTAAGCTCCTAC-1	LC_ER+
ATGCTTAAGGATCCGC-1	LC_ER-
ATGGACAAGCCTAATA-1	LC_ER-
ATGGACAAGGCGAAAC-1	LC_ER+
ATGGACAAGGTAACGA-1	LC_ER+
ATGGACAAGGTCCACA-1	LC_ER-
ATGGACAAGTTTCCGC-1	LC_ER-
ATGGCCCAGAACAAGT-1	LC_ER+
ATGGCCCAGCTTCCCG-1	Immature_BC
ATGGCCCAGGAGTCTT-1	LC_ER+
ATGGCCCAGGATTGAG-1	LC_ER+
ATGGCCCAGTGTGATC-1	LC_ER+
ATGGCCGGTACTTAGG-1	LC_ER+
ATGGCCGGTCCGTGAG-1	LC_ER-
ATGGCCGGTTTATCTG-1	Immature_BC
ATGGCTAGTAATCCCT-1	LC_ER-
ATGGCTGTCACCAATA-1	LC_ER+
ATGGCTTAGACAAGTG-1	LC_ER-
ATGGCTTAGCAGCTCA-1	LC_ER+
ATGGCTTAGGTCTTGG-1	LC_ER+
ATGGTCTAGGGATTAG-1	LC_ER+
ATGGTCTAGTCATTAG-1	LC_ER+
ATGGTGCGTTAATGCG-1	Immature_BC
ATGGTGCGTTGTTGCT-1	LC_ER-
ATGGTTATCACTAATG-1	LC_ER-
ATGGTTATCTCACTCA-1	LC_ER+
ATGTAACGTGTCCAGG-1	LC_ER+
ATGTAACGTTCCAGGG-1	LC_ER-
ATGTAAGCAAGTGAAC-1	LC_ER+
ATGTAAGCAATAATCC-1	LC_ER+
ATGTAAGCACCGGCTA-1	LC_ER+
ATGTAAGCACTAAGCC-1	HY_BC_ER+
ATGTAAGCAGGATTAA-1	LC_ER-
ATGTAAGCAGGTTATT-1	LC_ER-
ATGTAAGCATGTTGTG-1	LC_ER+
ATGTCAATCCAGGTCA-1	LC_ER-
ATGTCATCAGTTAAAG-1	LC_ER+
ATGTCATCATAAGTCT-1	LC_ER-
ATGTCATCATTAAGTC-1	LC_ER+
ATGTCCACAATCCCTT-1	Immature_BC
ATGTCCACACCCACAG-1	LC_ER+
ATGTCCACACCTCACC-1	LC_ER-
ATGTCCACAGCCAGAA-1	LC_ER-
ATGTGAGAGTTAGAGG-1	LC_ER-
ATGTTCAAGAGGAAGG-1	LC_ER+
ATGTTCAAGGACCGCT-1	LC_ER-
ATGTTCAAGGACCTTG-1	HY_ER+_ER-
ATGTTGTCAAGTAAGC-1	LC_ER-
ATGTTTGAGGCAAGTA-1	Immature_BC
ATGTTTGAGGGACTAA-1	LC_ER-
ATGTTTGAGGGTTAGA-1	LC_ER-
ATGTTTGAGTATTGGC-1	LC_ER-
ATGTTTGAGTTCCTGC-1	Immature_BC
ATTAACCCAAACCTAT-1	Immature_BC
ATTAACCCAATATAGG-1	LC_ER-
ATTAACCCACCAAAGG-1	LC_ER+
ATTAACCCATTAGCCA-1	LC_ER-
ATTACCCGTCCTTCTC-1	LC_ER+
ATTACCCGTTAGCCAA-1	LC_ER-
ATTACCCGTTGCGCGA-1	LC_ER+
ATTACCCGTTGCGGAT-1	LC_ER+
ATTACCGCAATCCTGA-1	LC_ER+
ATTACCGCAATTAGCT-1	LC_ER-
ATTACCGCACATTGCA-1	LC_ER-
ATTACGTCAAATTCGT-1	LC_ER+
ATTACGTCACCAAAGG-1	Immature_BC
ATTACGTCATGAATAG-1	HY_ER+_ER-
ATTACGTCATGTGGGA-1	LC_ER+
ATTACTGAGGAACGCG-1	LC_ER+
ATTACTGAGGCCAATT-1	Immature_BC
ATTACTGAGGCGGGTA-1	LC_ER+
ATTACTGAGGCTTAAC-1	LC_ER+
ATTACTGAGGTCAAAG-1	LC_ER+
ATTAGCGGTAGCCATA-1	LC_ER-
ATTAGCGGTCCGTAGG-1	Prolif
ATTAGCGGTCCTTCTC-1	LC_ER+
ATTAGCGGTGAGCACT-1	LC_ER+
ATTAGCGGTGGCTTCC-1	LC_ER+
ATTAGCGGTTAGCCAA-1	LC_ER-
ATTAGCGGTTCCTGTG-1	LC_ER+
ATTAGCGGTTGCATCT-1	LC_ER-
ATTAGCGGTTTACGTC-1	Immature_BC
ATTAGCTCACAATGTT-1	LC_ER-
ATTAGCTCAGCAGGTA-1	LC_ER-
ATTAGCTCATCCTGAA-1	LC_ER-
ATTAGGTGTACTTCAC-1	Immature_BC
ATTAGGTGTTAACGGC-1	LC_ER+
ATTAGGTGTTTCGCCA-1	Immature_BC
ATTAGTCCAAATATCC-1	LC_ER+
ATTAGTCCAATATGGA-1	HY_ER+_ER-
ATTAGTCCACCCTCAC-1	LC_ER-
ATTAGTCCATGTTGGC-1	LC_ER+
ATTATCCTCCAAGTGT-1	LC_ER+
ATTATCCTCCTGAATA-1	LC_ER+
ATTATCCTCCTTGAGG-1	LC_ER+
ATTATCCTCGAAGTGA-1	LC_ER-
ATTATCCTCTACCTCA-1	LC_ER+
ATTATCCTCTTTGTAC-1	LC_ER+
ATTATGGTCAGGATGA-1	LC_ER+
ATTATGGTCCCTGTTA-1	LC_ER-
ATTATGGTCGATATTG-1	LC_ER-
ATTATGGTCGGTTACG-1	LC_ER+
ATTATGGTCTAAGTGC-1	Prolif
ATTCAACCAGTTTCTC-1	LC_ER+
ATTCACTTCACTAAGC-1	LC_ER+
ATTCACTTCCAGGTTG-1	LC_ER+
ATTCACTTCCTAAGGT-1	LC_ER-
ATTCATGAGATAACCC-1	LC_ER+
ATTCATGAGCACCACA-1	LC_ER+
ATTCATGAGCAGCTAT-1	LC_ER-
ATTCATGAGCGCCTTT-1	LC_ER+
ATTCATGAGGCTACTG-1	LC_ER+
ATTCCGGAGAAACTGG-1	Immature_BC
ATTCCGGAGAACCTGT-1	Immature_BC
ATTCCGGAGCCTAACG-1	LC_ER-
ATTCCTAGTATTGTCC-1	LC_ER+
ATTCCTAGTGTGCAAC-1	LC_ER-
ATTCCTAGTTTACTTG-1	LC_ER+
ATTCCTCCAACTGGGA-1	LC_ER+
ATTCCTCCATGGTTAT-1	Immature_BC
ATTCGTTTCAAATCGC-1	Immature_BC
ATTCGTTTCATTGCGG-1	LC_ER-
ATTGAAGCAAGCCACT-1	LC_ER-
ATTGAAGCAATTAACC-1	HY_BC_ER+
ATTGAAGCAGCAAGGC-1	Immature_BC
ATTGAAGCAGGATGGC-1	LC_ER+
ATTGAAGCATCACTTC-1	LC_ER-
ATTGACTCAACAGGAT-1	LC_ER-
ATTGACTCAAGCTAAA-1	LC_ER-
ATTGACTCACAACCTA-1	Immature_BC
ATTGACTCACAATACT-1	LC_ER-
ATTGACTCAGCTCATA-1	HY_BC_ER+
ATTGACTCATTAAACC-1	LC_ER-
ATTGACTCATTCAGCA-1	LC_ER+
ATTGCACAGAGGAAGG-1	LC_ER-
ATTGCACAGCCTCTGT-1	LC_ER+
ATTGCACAGTATCGCG-1	LC_ER+
ATTGCAGGTCTAGCTT-1	Immature_BC
ATTGCAGGTGGGAACA-1	LC_ER-
ATTGCAGGTTGTGATG-1	LC_ER+
ATTGCGCCAGAAACGT-1	LC_ER-
ATTGCGCCAGAAATGC-1	LC_ER+
ATTGCGCCATCCCTCA-1	LC_ER+
ATTGCTCGTCGCATAA-1	LC_ER-
ATTGCTCGTGTGTCCC-1	LC_ER+
ATTGCTCGTGTTTGAG-1	LC_ER-
ATTGCTCGTTGTCCAT-1	LC_ER+
ATTGGCTAGCTCCCTG-1	LC_ER-
ATTGGTTCACAAAGCG-1	LC_ER-
ATTGGTTCACCGTTCC-1	LC_ER+
ATTGTCCGTACTTAGG-1	LC_ER-
ATTGTCCGTGAGCAAG-1	LC_ER+
ATTGTCCGTGTCCAAA-1	LC_ER-
ATTGTCCGTTAGGTGC-1	LC_ER-
ATTGTCCGTTCCGCAC-1	LC_ER+
ATTGTCCGTTTCAGGA-1	LC_ER+
ATTGTGATCAAACCTA-1	LC_ER+
ATTGTGATCAGCTAAC-1	LC_ER-
ATTGTGATCATGAGCT-1	Immature_BC
ATTTAGCCAAGATTCT-1	LC_ER-
ATTTAGCCAAGCTTAT-1	LC_ER-
ATTTAGGTCAACCAAC-1	Immature_BC
ATTTAGGTCCCTGGTT-1	LC_ER+
ATTTGCAAGCCGCTTT-1	LC_ER-
ATTTGCAAGGACCGCT-1	LC_ER-
ATTTGCAAGGAGTCTT-1	LC_ER+
ATTTGCAAGGGCCACT-1	LC_ER-
ATTTGCGCAAGCCACT-1	LC_ER+
ATTTGCGCAGGTTAAA-1	LC_ER+
ATTTGCGCATCCATCT-1	LC_ER-
ATTTGTGAGAGAAGGG-1	LC_ER+
ATTTGTGAGATGGAGC-1	LC_ER+
ATTTGTGAGCGATACT-1	LC_ER+
ATTTGTGAGGAGCATA-1	Prolif
ATTTGTGAGTAGGATG-1	Immature_BC
CAAACAACAAGCTTTG-1	LC_ER-
CAAACAACAGGCCATT-1	LC_ER+
CAAACACTCAAGTGAG-1	LC_ER-
CAAACACTCACTCAAA-1	LC_ER-
CAAACACTCAGAAACG-1	LC_ER+
CAAACACTCATAAGCC-1	Immature_BC
CAAACACTCCCGTTAC-1	LC_ER-
CAAACACTCCCTCACG-1	LC_ER-
CAAACATGTCACGAAC-1	LC_ER-
CAAACATGTCGACTAA-1	LC_ER-
CAAACATGTTAGAGGG-1	LC_ER-
CAAACATGTTCACTGT-1	LC_ER-
CAAACCGTCTAATTGG-1	LC_ER-
CAAACGCGTCAGGCAT-1	LC_ER-
CAAACGCGTCCAAGAC-1	LC_ER+
CAAACGCGTGCATCGG-1	LC_ER-
CAAACGCGTGTTTGTC-1	LC_ER+
CAAACTGGTAACGAGG-1	Immature_BC
CAAACTGGTGAACAAA-1	HY_ER+_ER-
CAAACTGGTTGGTTCT-1	LC_ER+
CAAACTGGTTTGGGTA-1	LC_ER+
CAAAGCGCACAAAGAC-1	LC_ER+
CAAAGCGCACAATGTT-1	LC_ER+
CAAAGGATCAGGATGA-1	LC_ER+
CAAAGGATCAGGTTTA-1	LC_ER-
CAAAGGATCGAAGTGA-1	LC_ER-
CAAAGGATCGTTATCT-1	HY_ER+_ER-
CAAAGGATCTAAGTGC-1	LC_ER-
CAAAGGATCTCATCAT-1	LC_ER-
CAAAGTGAGCCTGTTC-1	LC_ER+
CAAAGTGAGGTAGCTT-1	LC_ER+
CAAAGTGAGTGAGGTA-1	LC_ER+
CAAATCATCATTAGCA-1	LC_ER-
CAACAATGTTCAAGAT-1	HY_ER+_ER-
CAACAATGTTGGCCGA-1	LC_ER-
CAACAATGTTGGTGAC-1	LC_ER-
CAACAATGTTTGGGTA-1	LC_ER-
CAACAGGCAATAGTCT-1	Immature_BC
CAACAGGCACAATGCC-1	LC_ER-
CAACAGGCACCTAAGC-1	LC_ER-
CAACAGGCAGCAAGAT-1	LC_ER-
CAACAGGCATTATCCC-1	HY_ER+_ER-
CAACCCGCAACCCTCC-1	LC_ER+
CAACCCGCAATCCTAG-1	Immature_BC
CAACCCGCAGATTCAT-1	LC_ER+
CAACCCGCATAAACCT-1	LC_ER-
CAACCCTTCACCTGTC-1	LC_ER-
CAACCCTTCCTAATTC-1	LC_ER+
CAACTAATCAAGCCTG-1	LC_ER+
CAACTAATCATTGTTC-1	LC_ER+
CAACTAATCCCTGTTA-1	LC_ER+
CAACTAATCCTGAATA-1	LC_ER-
CAACTAGGTGCGCATG-1	Immature_BC
CAACTAGGTGTCCAGG-1	LC_ER-
CAACTAGGTGTTTCAC-1	LC_ER+
CAACTAGGTTACGCAA-1	HY_ER+_ER-
CAACTAGGTTGCTGGG-1	LC_ER-
CAACTAGGTTTATGGG-1	HY_BC_ER+
CAAGAACCACTGACTA-1	LC_ER+
CAAGAACCAGGTTAAA-1	LC_ER+
CAAGACAAGCACGATT-1	LC_ER+
CAAGACAAGGCTAATC-1	LC_ER-
CAAGACAAGTGAGGTA-1	LC_ER-
CAAGCTAGTACCGAAC-1	LC_ER+
CAAGCTAGTATTCGCT-1	LC_ER+
CAAGCTAGTCGAAGTC-1	LC_ER-
CAAGCTAGTGTTGTAG-1	LC_ER-
CAAGCTAGTTGCATCT-1	LC_ER-
CAAGGCTGTAGACAAA-1	LC_ER-
CAAGGCTGTAGGATTT-1	LC_ER+
CAAGGCTGTGTTTGCT-1	LC_ER+
CAAGGCTGTTAACGGC-1	LC_ER-
CAAGGCTGTTAGGTTG-1	LC_ER+
CAAGGGAGTAAGGTTT-1	LC_ER+
CAAGGGAGTCCTTTAA-1	LC_ER-
CAAGGGAGTCTAACAG-1	LC_ER+
CAAGGGAGTTATCCTA-1	LC_ER+
CAAGGTAAGACTTATG-1	LC_ER+
CAAGGTAAGCCTAACG-1	HY_ER+_ER-
CAAGGTAAGGCGGGTA-1	Immature_BC
CAAGGTAAGTCACCAG-1	LC_ER+
CAAGGTAAGTCTTGAA-1	LC_ER+
CAAGGTAAGTGACCTG-1	LC_ER-
CAAGGTTTCATTGACA-1	LC_ER+
CAAGGTTTCCGTCCAT-1	LC_ER-
CAAGGTTTCCGTTATT-1	LC_ER-
CAAGGTTTCGCAATCG-1	LC_ER-
CAAGTAACACAAACTT-1	LC_ER+
CAAGTATGTAATCGTG-1	LC_ER+
CAAGTATGTGTTGCTT-1	LC_ER-
CAAGTATGTTGCATCT-1	LC_ER+
CAAGTATGTTGTGACA-1	LC_ER-
CAAGTATGTTTGCTGT-1	LC_ER-
CAAGTGAAGCACAGCC-1	LC_ER-
CAAGTGAAGGTTACAC-1	LC_ER-
CAAGTGAAGTAAAGGT-1	LC_ER+
CAAGTGAAGTTATGTG-1	LC_ER-
CAAGTGAAGTTCCTGC-1	LC_ER+
CAAGTTATCATGTCAA-1	LC_ER-
CAAGTTATCCCGCCTA-1	LC_ER+
CAAGTTATCTTGAGGT-1	LC_ER+
CAATAGCTCAATGTGC-1	LC_ER-
CAATAGCTCCGCAACA-1	LC_ER-
CAATAGCTCTGGTCCT-1	LC_ER-
CAATATGTCTGGCAAT-1	LC_ER+
CAATCCCTCGCATCCT-1	Immature_BC
CAATCCTGTGCAACTA-1	LC_ER-
CAATCCTGTGCATTTC-1	Immature_BC
CAATCCTGTGCTCCAC-1	LC_ER-
CAATCCTGTGGTTCTT-1	LC_ER+
CAATCCTGTTAAGGTT-1	LC_ER+
CAATCGCCACACTAAT-1	LC_ER-
CAATCGCCACCCTCAC-1	LC_ER+
CAATCGCCACCTACTT-1	LC_ER+
CAATCGCCATAGTCAT-1	HY_ER+_ER-
CAATCGCCATTAGCGC-1	LC_ER-
CAATCTAAGAGGATAT-1	LC_ER+
CAATCTAAGGGCTTAT-1	LC_ER-
CAATGAACAATGCCTA-1	LC_ER+
CAATGAACACGTTACA-1	HY_ER+_ER-
CAATGAACAGAAATGC-1	LC_ER-
CAATGACTCAATAGCC-1	LC_ER-
CAATGACTCCTAGTAA-1	LC_ER+
CAATGACTCTTAATGG-1	LC_ER+
CAATGCCCACGTAAGG-1	LC_ER+
CAATGCCCAGGCATGA-1	LC_ER+
CAATGTCAGGACGTAA-1	LC_ER+
CAATGTCAGGCATTAC-1	LC_ER+
CAATGTCAGGTCCACA-1	LC_ER-
CAATGTCAGGTGAAAT-1	LC_ER+
CACAAGCGTCTAACAG-1	LC_ER-
CACAATATCAAACTCA-1	LC_ER+
CACAATATCGCTAGCA-1	LC_ER-
CACAGGCTCCTAAGGT-1	LC_ER+
CACAGGCTCTAGCGTG-1	LC_ER-
CACAGGGAGCTTGCTC-1	LC_ER+
CACAGGGAGGGTGGAT-1	LC_ER+
CACAGGGAGTAAACCC-1	LC_ER+
CACAGGGAGTAGAGGC-1	LC_ER+
CACAGGGAGTTAGGCT-1	LC_ER-
CACATAATCAACCAAC-1	LC_ER+
CACATAATCCGCCTCA-1	LC_ER+
CACATAATCGATATTG-1	LC_ER+
CACATAATCTACTAAG-1	LC_ER-
CACATACAGACAAGTG-1	LC_ER+
CACATACAGCACTAAC-1	LC_ER+
CACATACAGTTTGTCT-1	LC_ER-
CACATTAAGCCTGATG-1	LC_ER+
CACATTAAGGTCCACA-1	LC_ER+
CACATTAAGTCATCCC-1	LC_ER-
CACCAACCACCTAATG-1	HY_BC_ER+
CACCGGTAGCCGCTAA-1	Immature_BC
CACCGGTAGCTGAGGG-1	LC_ER-
CACCGGTAGGCGAAAC-1	LC_ER-
CACCGGTAGGGTTAGA-1	LC_ER+
CACCGGTAGTGAGCAA-1	LC_ER+
CACCGGTAGTGGCGGA-1	LC_ER+
CACCTCAGTCAAAGAA-1	LC_ER+
CACCTCAGTCTCAGCC-1	LC_ER+
CACCTCAGTTTAGTCC-1	HY_BC_ER+
CACCTGTTCGAAGTAG-1	LC_ER+
CACCTGTTCTTGTCCA-1	HY_ER+_ER-
CACGCAATCAAAGGCA-1	LC_ER+
CACGCAATCCAATTAG-1	LC_ER+
CACGCAATCCCTCATA-1	LC_ER+
CACGCTAAGCGCATTG-1	LC_ER-
CACGCTAAGCTCCTTA-1	LC_ER-
CACGCTAAGGTGTCCA-1	LC_ER+
CACGCTAAGTGATTCA-1	LC_ER+
CACTAAGGTGCATCGG-1	LC_ER-
CACTAAGGTGTGAGAG-1	LC_ER+
CACTAAGGTGTTTGCT-1	LC_ER-
CACTAAGGTTAGAGCC-1	LC_ER+
CACTAAGGTTCACCAT-1	LC_ER-
CACTAAGGTTGCATCT-1	LC_ER+
CACTAGCCACCATATG-1	HY_ER+_ER-
CACTAGCCAGGAAGCC-1	LC_ER+
CACTAGCCAGGCGATA-1	LC_ER+
CACTAGCCAGGTTAAA-1	LC_ER-
CACTGACCAACAACAA-1	LC_ER+
CACTGACCAATCCCTT-1	LC_ER+
CACTGACCAATTGAAG-1	LC_ER+
CACTGACCAGGCGATA-1	LC_ER-
CACTTAAAGCAAGACA-1	LC_ER+
CACTTAAAGCCTAATA-1	LC_ER+
CACTTAAAGCTCAATA-1	LC_ER-
CACTTAAAGTCACCAG-1	LC_ER-
CACTTTGTCCCTGACT-1	LC_ER-
CACTTTGTCCGTGACA-1	Immature_BC
CACTTTGTCTAACTGA-1	LC_ER-
CACTTTGTCTCACACC-1	LC_ER+
CAGAACCGTTCCGCAC-1	LC_ER+
CAGAATCTCACAGCGC-1	LC_ER+
CAGAATCTCAGGTTTA-1	LC_ER+
CAGAATCTCCCTCAAC-1	LC_ER+
CAGAATCTCCCTCATA-1	LC_ER+
CAGAATCTCCGCATGA-1	LC_ER+
CAGAATCTCCTCAGCT-1	LC_ER+
CAGAATCTCGCAGGCT-1	HY_ER+_ER-
CAGAATCTCTTAGCCC-1	LC_ER-
CAGATTCAGAATCGCT-1	LC_ER+
CAGATTCAGAGAGGAG-1	LC_ER+
CAGATTCAGCATGAAG-1	LC_ER+
CAGATTCAGTTAGAGG-1	LC_ER+
CAGATTCAGTTATGTG-1	Immature_BC
CAGATTCAGTTTGAGC-1	Immature_BC
CAGCAAGCAGAGGGAG-1	LC_ER-
CAGCAAGCAGTTTACG-1	LC_ER+
CAGCATGTCCTCCCTC-1	LC_ER-
CAGCATGTCGAGCTAT-1	LC_ER+
CAGCATGTCGGGACTC-1	Immature_BC
CAGCATTAGAGCCGGA-1	LC_ER+
CAGCATTAGCACCACA-1	LC_ER-
CAGCATTAGCCGCTAA-1	LC_ER-
CAGCATTAGGAACCAA-1	HY_ER+_ER-
CAGCATTAGGCCTAAT-1	LC_ER-
CAGCCAATCAGCAAGA-1	LC_ER-
CAGCCAATCATTACTC-1	LC_ER-
CAGCCAATCCGGGACT-1	LC_ER+
CAGCCAATCCTAATAG-1	LC_ER+
CAGCCAATCCTCGATC-1	LC_ER-
CAGCCAATCGCTTCTA-1	LC_ER+
CAGCCAATCTCCATAT-1	LC_ER-
CAGCCAATCTTGGACG-1	LC_ER+
CAGCCTTTCACCTGCT-1	LC_ER+
CAGCCTTTCGATTTGA-1	LC_ER+
CAGCCTTTCTAGCGTG-1	LC_ER-
CAGCTAAGTAGCTAAT-1	LC_ER+
CAGCTAAGTATTACCC-1	LC_ER+
CAGCTAAGTCATCAAG-1	Immature_BC
CAGCTAAGTGAAGCCT-1	LC_ER+
CAGCTATAGCGTGCGT-1	HY_ER+_ER-
CAGCTATAGCTGGACC-1	Immature_BC
CAGCTATAGGCGCTAC-1	LC_ER+
CAGCTATAGTGACCTG-1	LC_ER-
CAGCTCAAGCACAGAA-1	LC_ER-
CAGCTCAAGGCCTTAG-1	Immature_BC
CAGGAAGGTCCTAATC-1	Immature_BC
CAGGAAGGTTAGGCTA-1	LC_ER+
CAGGAAGGTTGCAATG-1	LC_ER-
CAGGACACAAGTCGCT-1	LC_ER+
CAGGACACACAATGCC-1	LC_ER+
CAGGACACACGTGCTG-1	HY_ER+_ER-
CAGGACACATAATCAC-1	LC_ER-
CAGGACCTCAAACCGT-1	Prolif
CAGGACCTCCCTGACT-1	LC_ER+
CAGGACCTCCGGTTGA-1	LC_ER+
CAGGACCTCCGTCCAT-1	LC_ER-
CAGGATGCAAAGCTAA-1	HY_ER+_ER-
CAGGATGCACTCAACA-1	LC_ER-
CAGGATGCATCCTGAA-1	LC_ER-
CAGGCTATCCAGGAAA-1	LC_ER+
CAGGCTATCCCTGTTA-1	LC_ER+
CAGGCTATCCTCATGC-1	LC_ER+
CAGGCTATCTACCTAT-1	LC_ER-
CAGGCTGGTAGGTTTG-1	LC_ER-
CAGGCTGGTAGTAAGA-1	Immature_BC
CAGGCTGGTTGCTGGG-1	LC_ER+
CAGGCTGGTTGTTGTC-1	LC_ER+
CAGGGCTTCACCGGTA-1	HY_ER+_ER-
CAGGGCTTCACCTGCT-1	LC_ER+
CAGGGCTTCCGCATGA-1	LC_ER-
CAGGGCTTCCTCATGC-1	HY_ER+_ER-
CAGGGCTTCTTACTCG-1	LC_ER-
CAGGGTGAGGCCTGGT-1	LC_ER+
CAGGGTGAGTCAATTG-1	LC_ER+
CAGGGTGAGTCACGAT-1	LC_ER-
CAGGGTGAGTCATTTC-1	LC_ER+
CAGGGTGAGTTATGGC-1	Immature_BC
CAGGTCCAGACTAAGG-1	LC_ER+
CAGGTCCAGGACCTCA-1	LC_ER+
CAGGTGGAGAAAGGAA-1	LC_ER-
CAGGTGGAGGACCTGC-1	Immature_BC
CAGGTGGAGGCATGAA-1	LC_ER-
CAGGTGGAGGCTATGT-1	LC_ER+
CAGGTGGAGGTCCTAG-1	LC_ER+
CAGGTTAGTGATGATT-1	LC_ER+
CAGGTTAGTTTAAAGC-1	HY_ER+_ER-
CAGGTTAGTTTACGTC-1	HY_ER+_ER-
CAGGTTTAGCCTGTTC-1	LC_ER-
CAGGTTTAGTCGCTAG-1	LC_ER-
CAGTACCCACAGGAAT-1	LC_ER+
CAGTACCCACCAACCG-1	LC_ER+
CAGTACCCAGCAATAA-1	LC_ER+
CAGTACCCAGGCTACT-1	LC_ER+
CATAACGGTACCGTTT-1	LC_ER-
CATAAGCTCAATTGGC-1	LC_ER-
CATAAGCTCATAGCCG-1	LC_ER-
CATAAGCTCGTTTCCA-1	LC_ER-
CATAATCCACGAATCC-1	LC_ER+
CATAATCCATAGCAGG-1	LC_ER-
CATAATGTCAATAGCC-1	LC_ER+
CATAATGTCCCGTTAC-1	LC_ER-
CATAATGTCCTCACTA-1	LC_ER+
CATAATGTCGCAAACT-1	LC_ER-
CATAATGTCGCATTAA-1	LC_ER+
CATAATGTCGCTCCAT-1	HY_ER+_ER-
CATAATGTCGTTAGCG-1	LC_ER+
CATAATGTCTCAATTC-1	Immature_BC
CATAGACTCGGGACTC-1	LC_ER+
CATAGACTCTGCAACG-1	LC_ER-
CATAGCTAGCATTTCT-1	LC_ER-
CATAGCTAGTAAGGGC-1	LC_ER-
CATAGCTAGTCCTGAG-1	LC_ER-
CATAGCTAGTGGACAA-1	LC_ER+
CATAGCTAGTTGGGCC-1	LC_ER-
CATAGGCGTCCGGTTC-1	LC_ER-
CATAGGCGTGTCCAGG-1	LC_ER+
CATAGGCGTTACTTCA-1	LC_ER-
CATAGGCGTTTGCTGT-1	Immature_BC
CATAGGTTCAGCACGC-1	LC_ER-
CATAGGTTCATGCTAA-1	LC_ER-
CATAGGTTCCGGAACC-1	Immature_BC
CATAGTCAGACTCGCA-1	LC_ER-
CATAGTCAGACTTATG-1	LC_ER-
CATAGTCAGCGCAATT-1	Immature_BC
CATAGTCAGGAGGACT-1	LC_ER-
CATAGTCAGTCATTTC-1	LC_ER-
CATAGTCAGTGGCGGA-1	Immature_BC
CATATCGCAAGGGTTG-1	LC_ER+
CATATCGCACCGGCTA-1	Immature_BC
CATATCGCAGCATGTC-1	LC_ER+
CATCAATCAACACTTG-1	LC_ER+
CATCACACAACTGGCT-1	LC_ER+
CATCACACATAGCGAG-1	LC_ER-
CATCAGCCAATAACCT-1	LC_ER-
CATCAGCCACAGGATG-1	LC_ER+
CATCATAAGTCGCTAG-1	LC_ER-
CATCATAAGTTTGTCT-1	LC_ER-
CATCATGCAATAATGG-1	HY_ER+_ER-
CATCATGCACTAAATC-1	Immature_BC
CATCATGCAGGTTCAC-1	LC_ER-
CATCATGCATTCCTCG-1	LC_ER-
CATCATGCATTGTGAT-1	LC_ER-
CATCCCAGTCAAACTG-1	Prolif
CATCCCAGTCCTCCAA-1	HY_BC_ER+
CATCCCAGTTCGCTCA-1	LC_ER-
CATCCCAGTTTGGGTA-1	LC_ER-
CATCCTCAGTATTGTG-1	LC_ER-
CATCCTCAGTTGGGCC-1	LC_ER+
CATCCTGGTTCCGGGA-1	LC_ER+
CATCCTGGTTTGTTGC-1	LC_ER+
CATCGCTTCCAGGTCA-1	LC_ER-
CATCGCTTCCATAATG-1	LC_ER-
CATCGCTTCCTTAGTT-1	LC_ER-
CATCGCTTCGATAACC-1	LC_ER+
CATCGCTTCTAATCTC-1	LC_ER-
CATGAGGCATCAGTAT-1	LC_ER+
CATGAGGCATTAAACC-1	LC_ER+
CATGCAAGTACTGAAT-1	LC_ER+
CATGCAAGTGTAATAC-1	Immature_BC
CATGCATAGCTCGCTT-1	LC_ER+
CATGCATAGCTTCCCG-1	LC_ER-
CATGCATAGGAACCAA-1	LC_ER+
CATGCATAGTCAGGCC-1	LC_ER+
CATGCGCAGCAGGTGG-1	Immature_BC
CATGCGCAGCCGCTTT-1	LC_ER+
CATGCGCAGGACAATG-1	LC_ER+
CATGCGCAGGAGGTTA-1	LC_ER+
CATGCGGGTATTGAGT-1	LC_ER-
CATGCGGGTATTTGGG-1	LC_ER+
CATGCGGGTCACTCGC-1	Immature_BC
CATGCGGGTGAGGTAG-1	LC_ER+
CATGCGGGTTAACAGT-1	LC_ER+
CATGGATTCATTGCGG-1	LC_ER-
CATGGATTCCGCCTCA-1	LC_ER+
CATGGATTCTGGCATG-1	LC_ER-
CATGGCGGTCATCATC-1	LC_ER-
CATGGCGGTCCTTCAG-1	Immature_BC
CATGGCGGTTCAAGAT-1	LC_ER-
CATGGCGGTTGGATAT-1	LC_ER+
CATGGCGGTTGTCATC-1	LC_ER+
CATTATCTCATTATGG-1	Immature_BC
CATTATCTCCCAGTAG-1	LC_ER+
CATTATCTCGCAACAT-1	LC_ER+
CATTATCTCTCTAGCC-1	LC_ER+
CATTATGAGGATCCGC-1	LC_ER+
CATTATGAGGCAACAA-1	LC_ER-
CATTATGAGTCACCAG-1	HY_ER+_ER-
CATTCATTCATGCTAA-1	LC_ER-
CATTCATTCCGGAACC-1	LC_ER-
CATTCATTCCTTAAGA-1	LC_ER+
CATTCATTCGAGGAAC-1	Immature_BC
CATTCCTCAAGTTATC-1	LC_ER-
CATTGCGAGCACGATT-1	Immature_BC
CATTGCGAGTCGCAAT-1	LC_ER-
CATTGTAAGATACTTG-1	LC_ER+
CATTGTAAGCAGGTTT-1	LC_ER+
CATTGTAAGTAAGGGC-1	HY_BC_ER+
CATTGTGCAAAGCGGC-1	LC_ER-
CATTGTGCAAAGCTAA-1	LC_ER-
CATTGTGCAAGTGTTT-1	LC_ER+
CATTGTGCAAGTTATC-1	LC_ER+
CATTGTGCACCTAATG-1	LC_ER-
CATTGTGCAGGTTCAC-1	LC_ER-
CATTTGTTCACTCGCT-1	LC_ER+
CATTTGTTCGTGCTAG-1	LC_ER-
CATTTGTTCTAAATCG-1	LC_ER-
CATTTGTTCTAAGGAG-1	LC_ER+
CATTTGTTCTGGTCCT-1	LC_ER-
CCAAACCCAAATGCCC-1	LC_ER+
CCAAACCCATAGCGGA-1	LC_ER+
CCAAACTAGAATGACG-1	HY_BC_ER+
CCAAACTAGATAGACG-1	LC_ER-
CCAAACTAGGAGGTTA-1	Prolif
CCAAACTAGTTCCCGT-1	LC_ER+
CCAAATCAGACACTTA-1	LC_ER-
CCAAATCAGCTGTCAG-1	LC_ER+
CCAAATCAGCTTACTT-1	LC_ER+
CCAAATCAGGCAGGTG-1	LC_ER+
CCAAATCAGGCGGATG-1	LC_ER+
CCAAATCAGGGATTAG-1	LC_ER+
CCAAATCAGGTGTTAC-1	LC_ER+
CCAACCAAGGTGAAAT-1	LC_ER-
CCAACCAAGGTGTCCA-1	LC_ER+
CCAACCAAGTTAGAGG-1	LC_ER+
CCAACCCGTAACCTAG-1	Immature_BC
CCAACCCGTATTGGAT-1	LC_ER-
CCAACCCGTCATTGAG-1	LC_ER+
CCAACCCGTGGTTATG-1	LC_ER+
CCAACCCGTTGCGCGA-1	LC_ER+
CCAACCCGTTGCTTCG-1	HY_ER+_ER-
CCAACCCGTTTAGCGA-1	LC_ER+
CCAACCCGTTTATGGG-1	LC_ER-
CCAAGGCTCCTTTACG-1	LC_ER-
CCAAGGCTCTCAATGA-1	LC_ER+
CCAAGTTAGACTTATG-1	Immature_BC
CCAAGTTAGCCTAATA-1	LC_ER+
CCAAGTTAGCCTGATG-1	LC_ER-
CCAAGTTAGTCATTGA-1	LC_ER-
CCAATATCATGTCAAT-1	LC_ER+
CCACAATAGGTCCTAG-1	Immature_BC
CCACACAAGAACCTAC-1	Immature_BC
CCACACAAGCTCATAA-1	HY_BC_ER+
CCACACAAGGTTTGCG-1	LC_ER-
CCACACAAGTGAACGA-1	LC_ER-
CCACAGGGTGTGCAAC-1	LC_ER-
CCACAGGGTTAATGAC-1	LC_ER-
CCACAGGGTTACAAAC-1	LC_ER+
CCACATTGTCTAACAG-1	LC_ER+
CCACTTGGTCAAACTG-1	LC_ER+
CCACTTGGTCGCGCAA-1	LC_ER-
CCACTTGGTGAAGCCT-1	LC_ER-
CCACTTGGTGAGGTGA-1	HY_ER+_ER-
CCACTTGGTTAGGCGT-1	LC_ER+
CCACTTGGTTGCACGG-1	LC_ER-
CCAGACTCAACTAGCC-1	LC_ER+
CCAGACTCACGAATTT-1	HY_BC_ER+
CCAGACTCACTGACCG-1	LC_ER-
CCAGACTCAGGCGAGT-1	LC_ER-
CCAGACTCAGGTTTGC-1	LC_ER+
CCAGACTCATCGCTCC-1	LC_ER-
CCAGCCTGTCCTCCAA-1	HY_ER+_ER-
CCAGCCTGTTATCCTA-1	LC_ER-
CCAGCTAAGCTCCTTA-1	LC_ER+
CCAGCTAAGCTGGCTA-1	LC_ER+
CCAGCTGCACCATATG-1	LC_ER-
CCAGCTGCAGGTTATT-1	LC_ER-
CCAGCTGCATAGCTTG-1	LC_ER-
CCAGGAACACCTCGCT-1	LC_ER+
CCAGGAACACGAATCC-1	Immature_BC
CCAGGAACAGCCAGTT-1	LC_ER-
CCAGGAACATTCAGCA-1	HY_ER+_ER-
CCAGGATGTATCTGGA-1	LC_ER-
CCAGGATGTGGGTGAA-1	Immature_BC
CCAGGATGTTGCCTCA-1	LC_ER+
CCAGTTTGTAATTAGC-1	LC_ER+
CCAGTTTGTTACCTGT-1	LC_ER-
CCAGTTTGTTTAAAGC-1	LC_ER+
CCATAAATCAATCTCT-1	Immature_BC
CCATAAATCAGGGCCT-1	LC_ER+
CCATAAATCATCGTTT-1	LC_ER-
CCATAATCAACACCTA-1	LC_ER+
CCATAATCAAGCGATG-1	Immature_BC
CCATAATCACAACAAA-1	HY_ER+_ER-
CCATAATCACGAACAG-1	LC_ER-
CCATAATCATAATTGC-1	LC_ER-
CCATAATCATCGTTCT-1	LC_ER+
CCATAATCATGCAACC-1	Immature_BC
CCATAGCCACAAAGCG-1	LC_ER-
CCATAGCCAGCACGAA-1	LC_ER+
CCATAGCCATGCTATG-1	LC_ER+
CCATATTTCAGGATGA-1	LC_ER+
CCATATTTCCAAGTGT-1	LC_ER+
CCATATTTCCCGCATT-1	Immature_BC
CCATATTTCTTTAAGG-1	LC_ER-
CCATCACTCATTACAG-1	LC_ER-
CCATCACTCCTCATCA-1	LC_ER-
CCATCACTCCTTTACG-1	Immature_BC
CCATCACTCGAAGTGA-1	LC_ER+
CCATCATGTATACTGG-1	LC_ER+
CCATCATGTTATCCGT-1	LC_ER+
CCATCATGTTTCCTCC-1	LC_ER-
CCATTATTCAGCAAAG-1	LC_ER+
CCATTATTCCTTGAGG-1	LC_ER+
CCATTGTGTCAAAGGG-1	LC_ER-
CCATTGTGTTGGCCGA-1	LC_ER+
CCCAAACCACGAACAG-1	LC_ER+
CCCAAACCAGGATGGC-1	LC_ER+
CCCAAACCATTCCTCG-1	LC_ER+
CCCAAATAGAATCGCT-1	LC_ER-
CCCAAATAGAGGCTAA-1	Immature_BC
CCCAAATAGATAACCC-1	LC_ER-
CCCAAATAGCTATTGA-1	HY_ER+_ER-
CCCAAATAGGTGCGGA-1	HY_ER+_ER-
CCCAAATAGTGCTGTG-1	LC_ER+
CCCAACCGTATCTGGA-1	LC_ER-
CCCAACCGTGGATTCA-1	LC_ER-
CCCAACCGTTATCCGT-1	LC_ER-
CCCAACCGTTTAGTCC-1	LC_ER+
CCCAATTGTAAGCTTG-1	LC_ER+
CCCAATTGTATTGGAT-1	HY_ER+_ER-
CCCAATTGTCACCTAT-1	Immature_BC
CCCAATTGTGAGCACT-1	Prolif
CCCAATTGTGGATGTC-1	LC_ER+
CCCAGCACATAGCTGC-1	LC_ER+
CCCAGCACATGTCGCG-1	LC_ER+
CCCAGTTTCATGTCAA-1	LC_ER-
CCCAGTTTCGAGGAGT-1	LC_ER+
CCCATAACAAGCGAGC-1	LC_ER-
CCCATAACACGTTACA-1	LC_ER+
CCCGCAACAATTGACT-1	LC_ER-
CCCGCTTCAGAATGAC-1	LC_ER+
CCCGTAAAGAAGCTAG-1	LC_ER+
CCCGTAAAGACTTACA-1	LC_ER+
CCCGTAAAGGCTCATG-1	LC_ER-
CCCGTTGTCACTAGGT-1	LC_ER-
CCCGTTGTCAGCAAGA-1	LC_ER+
CCCGTTGTCCGCAAAT-1	Immature_BC
CCCGTTGTCTAGCTTT-1	LC_ER-
CCCTAATGTAACGTGC-1	LC_ER+
CCCTAATGTCCACAAA-1	LC_ER-
CCCTAATGTGTTAGCA-1	LC_ER+
CCCTAATGTTAGGATT-1	HY_ER+_ER-
CCCTCACCAACCCTCC-1	LC_ER-
CCCTCACCAGGCCATT-1	LC_ER+
CCCTCACCAGTAATAG-1	LC_ER-
CCCTCACCAGTCTAAT-1	LC_ER+
CCCTCACCATCATGTG-1	LC_ER+
CCCTCAGTCATTAGTG-1	LC_ER+
CCCTCAGTCATTGACA-1	LC_ER+
CCCTCAGTCCGCACAA-1	LC_ER+
CCCTCAGTCCTCATCA-1	LC_ER-
CCCTCAGTCGAGCAAA-1	LC_ER+
CCCTCAGTCTAAATCG-1	LC_ER-
CCCTCATAGGCCAATT-1	LC_ER+
CCCTCATAGGTCCAAT-1	LC_ER+
CCCTCATAGTCACCAG-1	LC_ER+
CCCTGGACAATGCCCG-1	LC_ER-
CCCTGGACAGTATGTT-1	LC_ER+
CCCTTAATCCAGGAAA-1	Immature_BC
CCGACAGGTAAGGTTT-1	LC_ER+
CCGACAGGTAGGTTGC-1	LC_ER+
CCGACAGGTATTTGGG-1	LC_ER-
CCGACAGGTTCGCTTG-1	Immature_BC
CCGACAGGTTGGGTTA-1	LC_ER-
CCGATGCAGCCACATG-1	LC_ER-
CCGATGCAGTAACCCG-1	Immature_BC
CCGATGCAGTATTGTG-1	Immature_BC
CCGCAAATCAATGTCA-1	LC_ER-
CCGCAAATCGGGATTT-1	LC_ER-
CCGCAAATCTGCAAGT-1	LC_ER-
CCGCAAGGTAATTAGC-1	LC_ER+
CCGCAAGGTGTTGTAG-1	HY_ER+_ER-
CCGCAAGGTTGGTTAG-1	LC_ER-
CCGCACACAAACTGTT-1	LC_ER-
CCGCACACAGTAAGTA-1	LC_ER+
CCGCCAACACCTAATG-1	LC_ER+
CCGCCAACACCTGGTG-1	LC_ER-
CCGCTAAAGGCTACTG-1	LC_ER+
CCGCTAGCAGCCAGTT-1	LC_ER-
CCGCTAGCATATAACC-1	Immature_BC
CCGCTTAGTGTTGCTT-1	Immature_BC
CCGGTAGGTCCGTAGG-1	LC_ER+
CCGGTAGGTTAGGCTA-1	LC_ER+
CCGTTAACAAACAACA-1	LC_ER-
CCGTTAACAAGTAAGC-1	LC_ER-
CCGTTAACAGCTAACC-1	LC_ER+
CCGTTAACATCCAGGT-1	LC_ER-
CCGTTACTCCCTCGCA-1	LC_ER-
CCGTTACTCCGGTTGA-1	LC_ER-
CCGTTACTCTCATCAT-1	Immature_BC
CCGTTATGTCTATCGT-1	LC_ER+
CCGTTATGTGGATTAT-1	LC_ER+
CCGTTATGTTTGCGAA-1	LC_ER+
CCGTTGCGTCCTAACT-1	LC_ER-
CCGTTGCGTGATTTGG-1	Immature_BC
CCGTTGCGTGTGCAAC-1	Immature_BC
CCGTTGCGTTTATCGC-1	LC_ER-
CCTAAAGGTAGGATTT-1	LC_ER+
CCTAAAGGTCGCAATA-1	HY_ER+_ER-
CCTAAAGGTTGAAGCC-1	LC_ER-
CCTAAATCAATACTGT-1	LC_ER+
CCTAAATCAGCAAGAT-1	LC_ER-
CCTAAATCAGTAGGAT-1	LC_ER-
CCTAAATCATCAGTAT-1	Immature_BC
CCTAAATCATGCTTAG-1	LC_ER-
CCTAAGCCAAGTGTTT-1	LC_ER+
CCTAAGCCAGATTCAT-1	HY_BC_ER+
CCTAAGCCATCCCTCA-1	HY_ER+_ER-
CCTAAGGTCCCGAAGC-1	LC_ER-
CCTAAGGTCCGCCTAT-1	LC_ER+
CCTAAGGTCTTGATGA-1	LC_ER+
CCTAAGTAGCTATTAG-1	LC_ER-
CCTAAGTAGGTAAGGC-1	LC_ER-
CCTAAGTAGTGAACAG-1	LC_ER+
CCTAATAAGAACAAGT-1	Immature_BC
CCTAATAAGGTGTCCA-1	LC_ER-
CCTAATAAGTAATCCA-1	LC_ER+
CCTAATCGTCCAAATG-1	LC_ER+
CCTAATCGTGATGGCT-1	LC_ER+
CCTACTGGTGCATTAG-1	LC_ER+
CCTACTTCAATAACGA-1	LC_ER-
CCTATAGCATTAAACC-1	LC_ER+
CCTATATTCCATAAGC-1	LC_ER-
CCTATATTCGATCAGT-1	LC_ER-
CCTATATTCGCCTGTT-1	LC_ER-
CCTATATTCGGCTAGC-1	Immature_BC
CCTATTGTCCCTGGAA-1	LC_ER-
CCTATTGTCGGTCAGC-1	Immature_BC
CCTATTGTCTAGCTAA-1	LC_ER+
CCTATTTAGGCGGGTA-1	LC_ER+
CCTATTTAGTCATGCG-1	LC_ER+
CCTCAAACAACTAGAA-1	LC_ER-
CCTCAAACACATGCTA-1	LC_ER-
CCTCAAACACGTGCTG-1	LC_ER+
CCTCAATGTAATCGGC-1	LC_ER+
CCTCAATGTTAATGCG-1	Immature_BC
CCTCAATGTTAGGTTG-1	Immature_BC
CCTCAATGTTATGTGG-1	LC_ER-
CCTCAGTTCGTTACAA-1	LC_ER-
CCTCCTCTCAATCTCT-1	Immature_BC
CCTCCTCTCAGGCCTA-1	LC_ER-
CCTCCTCTCATAATCG-1	LC_ER+
CCTCCTCTCGTTCACC-1	LC_ER-
CCTCCTCTCTACTAAG-1	LC_ER+
CCTCCTCTCTTGAGGT-1	LC_ER+
CCTCCTGAGGGTTAGA-1	HY_ER+_ER-
CCTGAATAGCACGATT-1	LC_ER+
CCTGAATAGCCAAATC-1	LC_ER-
CCTGAATAGGAACGCG-1	LC_ER-
CCTGAATAGGATTGAG-1	LC_ER-
CCTGAATAGGCCAATT-1	HY_ER+_ER-
CCTGAATAGGCGCTAC-1	LC_ER-
CCTGAATAGGGATGAC-1	LC_ER+
CCTGAATAGGTCCACA-1	LC_ER-
CCTGAATAGTTGTCTT-1	LC_ER+
CCTGACTTCGGCCAGT-1	Immature_BC
CCTGACTTCGGTTTGG-1	LC_ER+
CCTGACTTCTCACTAT-1	LC_ER+
CCTGAGTCAAGGTGGC-1	LC_ER-
CCTGAGTCAATGAGGT-1	LC_ER+
CCTGAGTCATAAGGAC-1	LC_ER-
CCTGAGTCATAATCAC-1	Immature_BC
CCTGATGAGCCTGACA-1	Immature_BC
CCTGATGAGGCTGGCT-1	LC_ER+
CCTGATGAGGTAGCTT-1	LC_ER-
CCTGATGAGTATTGTG-1	LC_ER-
CCTGATGAGTTAGACC-1	LC_ER-
CCTGCTCCACGAATCC-1	Immature_BC
CCTGCTCCAGTACCGT-1	LC_ER-
CCTGCTCCATAATGAG-1	Immature_BC
CCTGCTCCATCCCGCT-1	LC_ER-
CCTGCTCCATGATTGT-1	LC_ER-
CCTGGATCAATTAGGA-1	LC_ER-
CCTGGATCACAATGTT-1	LC_ER+
CCTGGATCACATACTG-1	LC_ER+
CCTGGTAAGCATGTTA-1	LC_ER-
CCTGGTAAGCGTGCGT-1	LC_ER+
CCTGGTAAGGCAGGTG-1	LC_ER+
CCTGGTAAGGCTATGT-1	LC_ER-
CCTGGTAAGGGACGCA-1	LC_ER-
CCTGGTAAGGTACCGC-1	LC_ER-
CCTGTAACAAGGTCCT-1	Immature_BC
CCTGTAACAGCGCTTG-1	LC_ER+
CCTGTAACAGTTATCG-1	LC_ER-
CCTGTAACATCACTTC-1	LC_ER-
CCTGTATGTAATCGGC-1	LC_ER+
CCTGTATGTGCAATAT-1	LC_ER-
CCTGTATGTGCCTCAC-1	LC_ER+
CCTGTATGTTCACCAT-1	LC_ER-
CCTGTATGTTGGCCGA-1	LC_ER-
CCTGTTGGTGTTAAAC-1	LC_ER+
CCTGTTGGTTAAATGC-1	LC_ER-
CCTGTTGGTTGGTGAC-1	LC_ER+
CCTTAACGTCACACCC-1	Immature_BC
CCTTAACGTCATAAGT-1	HY_ER+_ER-
CCTTACTCACTTAACG-1	LC_ER+
CCTTACTCAGTAGGTG-1	Immature_BC
CCTTACTCATCCTGAA-1	LC_ER-
CCTTAGTGTACCAGGT-1	LC_ER-
CCTTAGTGTCCTAACT-1	Immature_BC
CCTTAGTGTCGCGCAA-1	LC_ER-
CCTTAGTGTGAGCGAA-1	LC_ER+
CCTTAGTGTGAGGTAG-1	LC_ER-
CCTTATGTCAACAAGG-1	HY_BC_ER+
CCTTATGTCCCGAACA-1	Immature_BC
CCTTATGTCGTTATCT-1	LC_ER+
CCTTATGTCTCGCCCA-1	LC_ER-
CCTTATGTCTGTAAGC-1	LC_ER+
CCTTCAATCAAGCTAC-1	LC_ER+
CCTTCAATCGAGCAAA-1	Immature_BC
CCTTCAATCTTAGGGT-1	LC_ER-
CCTTCAGGTACCGTAA-1	LC_ER+
CCTTCAGGTAGTTAAC-1	HY_ER+_ER-
CCTTCAGGTGTCCTGC-1	LC_ER+
CCTTCAGGTGTTGTAG-1	Immature_BC
CCTTCAGGTTACAACG-1	LC_ER+
CCTTCAGGTTGAAGCC-1	LC_ER+
CCTTCAGGTTGGTGAC-1	LC_ER-
CCTTCGGTCATCCTAT-1	LC_ER+
CCTTCGGTCGCATCCT-1	LC_ER-
CCTTCGGTCGTTAAGC-1	LC_ER-
CCTTCGGTCTGCAACG-1	HY_ER+_ER-
CCTTCGTAGCATGGTT-1	LC_ER-
CCTTCGTAGCTGTCAG-1	LC_ER-
CCTTCGTAGTTGTCTT-1	LC_ER-
CCTTGCGTCAATGAGG-1	LC_ER-
CCTTGCGTCATGTGGT-1	LC_ER+
CCTTGCGTCCAGGTCA-1	LC_ER-
CCTTGCGTCGCTAGAT-1	LC_ER+
CCTTGCGTCTACCTGC-1	LC_ER-
CCTTGCGTCTTGATGA-1	LC_ER-
CCTTGTTCAATGAGGT-1	LC_ER+
CCTTGTTCATGCTCCC-1	Immature_BC
CCTTTAGTCGCTAGCA-1	LC_ER-
CCTTTAGTCGTGCTAG-1	LC_ER+
CCTTTAGTCTAGCTAA-1	LC_ER+
CGAAATGAGGGTTATC-1	LC_ER+
CGAACAAAGCTTTGTT-1	LC_ER-
CGAACAAAGGAGCACG-1	LC_ER+
CGAACAAAGGCTACTG-1	LC_ER+
CGAACAAAGGCTGTGC-1	LC_ER-
CGAACAAAGGTCGAGG-1	LC_ER-
CGAACAAAGTGAACCT-1	LC_ER+
CGAACCGGTCAAAGGG-1	LC_ER+
CGAACCGGTGGAGCAA-1	LC_ER-
CGAACCGGTGGATGTC-1	LC_ER+
CGAACCGGTGTGTGGT-1	HY_ER+_ER-
CGAACCGGTTTACCGT-1	LC_ER+
CGAAGCGAGAAGCTAG-1	LC_ER+
CGAAGCGAGCATTTCT-1	LC_ER+
CGAAGCGAGGCGGGTA-1	LC_ER-
CGAAGCGAGGTCCAAT-1	LC_ER+
CGAAGCGAGTATTGGC-1	LC_ER+
CGAAGCGAGTCACTCC-1	Immature_BC
CGAAGCGAGTCGCTAG-1	LC_ER+
CGAAGGCCAGCAAGGC-1	LC_ER+
CGAAGGCCAGTAGGAT-1	LC_ER+
CGAAGGCCAGTATGTT-1	HY_ER+_ER-
CGAAGGCCATGTTGTG-1	LC_ER-
CGAAGTAAGAGCCGGA-1	LC_ER+
CGAAGTAAGCCTGACA-1	LC_ER-
CGAAGTAAGCTCCCTG-1	Immature_BC
CGAAGTAAGGAGCACG-1	LC_ER-
CGAATATGTACCGTTT-1	LC_ER+
CGAATATGTTACTAGG-1	HY_BC_ER+
CGAATATGTTGGCCGA-1	LC_ER+
CGAATCTAGCTGGAAA-1	LC_ER+
CGAATCTAGTAAAGGT-1	LC_ER+
CGACAAGCAATACTGT-1	LC_ER+
CGACAAGCACAATGTT-1	LC_ER+
CGACAAGCAGTACCGT-1	LC_ER+
CGACCTGCAATTAACC-1	LC_ER-
CGACCTGCAGAAACGT-1	LC_ER+
CGACCTGCAGCAACCT-1	LC_ER-
CGACCTGCATGAGTTT-1	LC_ER+
CGACCTGCATTAGGCC-1	LC_ER+
CGACTAAGTTTGACCT-1	LC_ER-
CGACTAAGTTTGTGGA-1	LC_ER-
CGAGCGAAGCCGCAAC-1	LC_ER-
CGAGCGAAGGACACTT-1	LC_ER-
CGAGCTGGTAATGGAA-1	LC_ER+
CGAGCTGGTAGCAGCT-1	LC_ER-
CGAGCTGGTCAAACTG-1	LC_ER+
CGAGCTGGTCAATGTG-1	LC_ER+
CGAGCTGGTCGAAGTC-1	LC_ER-
CGAGCTGGTGGTTATG-1	LC_ER+
CGAGGAAGTAGTTAAC-1	LC_ER+
CGAGGAAGTGCCTCAC-1	LC_ER-
CGAGGAAGTGTGCACG-1	LC_ER-
CGAGGAAGTTTGTCTA-1	LC_ER+
CGAGGCAAGAATCTCA-1	LC_ER+
CGAGGCAAGCAGCTCA-1	LC_ER+
CGAGGCAAGTAGCGCC-1	LC_ER-
CGAGGTGAGTTGGCCA-1	LC_ER+
CGAGTCGGTAACGTGC-1	LC_ER+
CGAGTCGGTGATGAAA-1	LC_ER-
CGAGTCGGTGGACCTG-1	LC_ER+
CGAGTCGGTGTAACCA-1	LC_ER+
CGAGTCGGTTAACGGC-1	HY_ER+_ER-
CGATATTCACTGACTA-1	HY_ER+_ER-
CGATGTCCAACCTAAT-1	HY_ER+_ER-
CGATGTCCAATGCGCT-1	Immature_BC
CGATGTCCAGGCTACT-1	LC_ER+
CGATGTCCAGTCTAAT-1	Immature_BC
CGATGTCCATCTAGCA-1	LC_ER-
CGATTATCACTTGTTC-1	LC_ER+
CGATTATCAGTTATGT-1	LC_ER+
CGATTATCATTGCGTA-1	LC_ER-
CGATTATCATTGTGCA-1	LC_ER+
CGATTCCTCCGCACAA-1	LC_ER+
CGATTCCTCCTGATGG-1	HY_ER+_ER-
CGATTGAGTGTTGTGA-1	Immature_BC
CGATTGAGTTAGCTGA-1	LC_ER+
CGATTTGCACTAGGTC-1	HY_ER+_ER-
CGATTTGCATTGCGTA-1	LC_ER-
CGCAAATTCAAAGGCA-1	Immature_BC
CGCAAATTCATAACCA-1	Immature_BC
CGCAAATTCATTACAG-1	LC_ER-
CGCAAATTCCACCCTG-1	LC_ER+
CGCAAATTCGGGACTC-1	LC_ER+
CGCAAATTCTTTAGGA-1	LC_ER+
CGCAATAGTGTCCAAA-1	LC_ER+
CGCAATAGTGTGCACG-1	LC_ER+
CGCAATAGTTTAGCTC-1	LC_ER-
CGCAATCCACGTGCTG-1	LC_ER+
CGCAATGTCCTAAGGT-1	LC_ER-
CGCAATGTCGCTCCAT-1	LC_ER-
CGCAATGTCTTCAATC-1	LC_ER-
CGCAATTAGCAACATC-1	LC_ER+
CGCAATTAGTGAGAGC-1	LC_ER+
CGCAATTAGTGAGCGG-1	LC_ER+
CGCACACAGCCTTAAA-1	LC_ER-
CGCACACAGCTCCTAC-1	LC_ER+
CGCACCACAAACCTAT-1	LC_ER-
CGCACCACACGAATTT-1	LC_ER-
CGCACCACAGGCTTCG-1	LC_ER+
CGCATATAGATGGACA-1	LC_ER+
CGCATATAGTTCCTGC-1	LC_ER+
CGCATGATCAAGGACA-1	LC_ER+
CGCATGATCATGCTTT-1	LC_ER+
CGCATGATCCGGTTAG-1	LC_ER+
CGCATTACAGACAAAC-1	LC_ER-
CGCATTACAGCTCATA-1	LC_ER+
CGCATTACATGCAACC-1	LC_ER+
CGCATTACATTGTGCA-1	LC_ER+
CGCCAAATCATAGACC-1	Immature_BC
CGCCAAATCGTTACTT-1	LC_ER-
CGCCAAATCTAAATCG-1	Immature_BC
CGCCAAATCTACTAAG-1	LC_ER-
CGCCACACAATAACGA-1	LC_ER-
CGCCTCATCATCCACC-1	LC_ER-
CGCCTCATCCTAGTTT-1	LC_ER+
CGCCTCATCCTCAGTC-1	LC_ER+
CGCCTCATCCTTAGGG-1	LC_ER+
CGCCTCATCGGTTTCC-1	LC_ER-
CGCCTGTGTCCCGGAA-1	Immature_BC
CGCCTGTGTGTTAAAC-1	LC_ER+
CGCCTGTGTTTACCGT-1	LC_ER-
CGCCTGTGTTTACTTG-1	LC_ER-
CGCGATTCAAGCTACC-1	LC_ER+
CGCGATTCAATCCCTT-1	LC_ER+
CGCGATTCATGACTAT-1	Immature_BC
CGCGGATTCAAACCGT-1	LC_ER+
CGCGGATTCCTAGTAA-1	HY_ER+_ER-
CGCGGATTCCTGCGAA-1	LC_ER-
CGCGGATTCTTAGCGG-1	Immature_BC
CGCTAACCAACAACAA-1	LC_ER+
CGCTAACCACCTGTAA-1	LC_ER-
CGCTAATAGTCATCCC-1	LC_ER-
CGCTAATAGTCATGCG-1	LC_ER+
CGCTAATAGTTTGGTA-1	LC_ER-
CGCTACTTCGACAAAG-1	LC_ER-
CGCTACTTCTTGCAAA-1	LC_ER-
CGCTATGAGAACCTAC-1	LC_ER+
CGCTATGAGAGAGGAG-1	LC_ER-
CGCTATGAGCGGTTAT-1	LC_ER-
CGCTATGAGTCTGGGC-1	LC_ER-
CGCTCCATCAAACCTA-1	LC_ER-
CGCTCCATCCTCATCA-1	LC_ER-
CGCTCCATCGCCTGTT-1	LC_ER-
CGCTCCATCGCTATAA-1	LC_ER-
CGCTCCATCGCTTGCT-1	LC_ER+
CGCTCCATCTTCAATC-1	LC_ER+
CGCTGTGCAACAGCCT-1	LC_ER+
CGCTGTGCACCTAATG-1	LC_ER+
CGCTGTGCAGAGAGCC-1	LC_ER-
CGCTGTGCAGTGAACG-1	LC_ER-
CGCTGTGCATGTTTGG-1	LC_ER-
CGCTTACTCCTTAGTT-1	LC_ER-
CGCTTACTCGATTTGA-1	LC_ER+
CGCTTCTAGCACTTGG-1	LC_ER+
CGCTTCTAGGAAACTG-1	LC_ER+
CGCTTGCGTCATTAGG-1	LC_ER+
CGCTTGCGTGAGCACT-1	LC_ER-
CGCTTGCGTTACCGGG-1	LC_ER+
CGGAATCGTAGTAAGA-1	LC_ER-
CGGAATCGTCGCATAA-1	LC_ER-
CGGAATCGTGGTTAGC-1	LC_ER-
CGGAATCGTGGTTATG-1	LC_ER-
CGGAATCGTTACTTCA-1	Immature_BC
CGGAATCGTTCATCTA-1	LC_ER-
CGGACAACACCCACAG-1	LC_ER-
CGGACAACATAAGTTC-1	Immature_BC
CGGACCTAGCTATATG-1	Immature_BC
CGGACCTAGCTTATGA-1	LC_ER+
CGGACCTAGGACAATG-1	LC_ER-
CGGACCTAGGACTTAC-1	LC_ER+
CGGACCTAGTAACTCA-1	LC_ER+
CGGACCTAGTCCTGAG-1	Immature_BC
CGGAGCAAGCTGTAAC-1	Immature_BC
CGGAGCAAGGCTACAT-1	HY_ER+_ER-
CGGAGCAAGGTCCGTA-1	LC_ER-
CGGAGCAAGTAGCGCC-1	HY_ER+_ER-
CGGAGCAAGTTGGATC-1	Immature_BC
CGGAGTCTCAAACCTA-1	LC_ER+
CGGAGTCTCACAAGCT-1	LC_ER-
CGGAGTCTCACGCATG-1	LC_ER+
CGGAGTCTCATTACGA-1	LC_ER-
CGGAGTCTCTATCGCC-1	LC_ER-
CGGAGTCTCTCGCCCA-1	Immature_BC
CGGATAAAGACACCGC-1	Immature_BC
CGGATAAAGCAAGGGT-1	LC_ER+
CGGATAAAGCCTCTGT-1	LC_ER+
CGGATAAAGCGCCTAA-1	LC_ER+
CGGATAAAGTAAGGGC-1	LC_ER+
CGGATTAGTGAGCAAG-1	LC_ER-
CGGATTAGTTTATCGC-1	LC_ER-
CGGCAATGTAGGTTAT-1	LC_ER+
CGGCAATGTCGCAATA-1	LC_ER-
CGGCAATGTGTTCCCA-1	LC_ER-
CGGCCATAGGCGGGTA-1	LC_ER-
CGGCCATAGGCTACAT-1	LC_ER-
CGGCTAATCAATCTCT-1	LC_ER-
CGGCTAATCAGCAAAG-1	LC_ER+
CGGCTAATCAGGTCCA-1	Immature_BC
CGGCTAATCTAATTGG-1	LC_ER+
CGGCTCACATGATTGT-1	LC_ER-
CGGCTCACATTAGCGC-1	Immature_BC
CGGGACAAGACTATTG-1	LC_ER-
CGGGACAAGACTTACA-1	HY_ER+_ER-
CGGGACAAGAGGGACT-1	LC_ER-
CGGGACAAGCATTAGC-1	LC_ER-
CGGGACAAGCGATACT-1	LC_ER+
CGGGACAAGGACCAGG-1	LC_ER-
CGGGACAAGGTGAAAT-1	LC_ER-
CGGGCTTAGCACGATT-1	HY_ER+_ER-
CGGGCTTAGCACTTGG-1	LC_ER-
CGGGCTTAGCTGAGGG-1	LC_ER+
CGGGCTTAGGACCTGC-1	LC_ER+
CGGGTATGTTAACACG-1	LC_ER-
CGGGTATGTTTGGCGG-1	LC_ER-
CGGGTCTAGTTATCCT-1	LC_ER+
CGGGTCTAGTTTGTCT-1	LC_ER+
CGGTAACGTCACTCGC-1	LC_ER-
CGGTAACGTCTCACTG-1	LC_ER+
CGGTAACGTGGACCTG-1	LC_ER+
CGGTAACGTGTCCAAA-1	HY_ER+_ER-
CGGTAACGTTACATCC-1	LC_ER+
CGGTGAACAGTTTGGC-1	LC_ER-
CGGTGAACATTAAGCT-1	LC_ER+
CGGTGAACATTCCTGT-1	LC_ER+
CGGTGAGAGAGGAGTC-1	LC_ER+
CGGTGAGAGCATGCAT-1	Immature_BC
CGGTGAGAGTCCTTCA-1	LC_ER-
CGGTTATAGTAATCCA-1	LC_ER-
CGGTTCCGTAAGCTTG-1	Immature_BC
CGGTTCCGTGCTTAGA-1	Immature_BC
CGGTTGGGTACTTAGG-1	LC_ER+
CGGTTGGGTTAGCATG-1	Immature_BC
CGGTTTCTCATCCACC-1	LC_ER+
CGGTTTCTCCCGCAAA-1	LC_ER-
CGGTTTCTCTACTAAG-1	Immature_BC
CGGTTTGAGCCGCAAC-1	LC_ER-
CGGTTTGAGCGCCTTT-1	LC_ER-
CGGTTTGAGGGTTAGA-1	LC_ER-
CGGTTTGAGGTAAGCA-1	LC_ER+
CGGTTTGAGTAACCCG-1	LC_ER+
CGTAACCCAAACCCTA-1	LC_ER+
CGTAACCCAATAGCCC-1	LC_ER+
CGTAACCCAGCAATAA-1	LC_ER+
CGTAACCCATGCAACC-1	LC_ER-
CGTAACCCATTTGCTC-1	HY_ER+_ER-
CGTAACTAGCACTAAC-1	LC_ER-
CGTAACTAGCGAAGTA-1	LC_ER-
CGTAACTAGCTTCCCG-1	LC_ER+
CGTAACTAGGCATGAA-1	HY_ER+_ER-
CGTAACTAGGTTTACA-1	LC_ER+
CGTAACTAGTATTGGC-1	LC_ER+
CGTAATGGTAGTTAAC-1	LC_ER-
CGTAATGGTCAGTAAT-1	LC_ER+
CGTAATGGTTAACACG-1	LC_ER-
CGTAATGGTTCCGCAC-1	LC_ER+
CGTACGGGTTAGGTGC-1	LC_ER+
CGTACGGGTTTGGTTC-1	LC_ER-
CGTAGCGGTAGCCTCC-1	LC_ER-
CGTAGCGGTCAATACG-1	Immature_BC
CGTAGCGGTCACAAAT-1	Immature_BC
CGTAGCGGTTAGACCA-1	LC_ER+
CGTAGCGGTTAGAGCC-1	LC_ER+
CGTAGCGGTTGGTTCT-1	Immature_BC
CGTAGTTAGATTGAGG-1	LC_ER+
CGTAGTTAGGCTAGAA-1	LC_ER-
CGTAGTTAGGGTTATC-1	LC_ER-
CGTATTGCAAGCTTAT-1	Immature_BC
CGTATTGCAGCCTTGG-1	LC_ER-
CGTATTGCAGGTTACC-1	Immature_BC
CGTATTGCAGTTAAAG-1	HY_BC_ER+
CGTATTGCATAAGTCT-1	LC_ER-
CGTATTGCATCCCGCT-1	LC_ER-
CGTATTGCATGTTGGC-1	LC_ER-
CGTCAATAGGCAAGTA-1	LC_ER+
CGTCATTGTAACCTAG-1	LC_ER+
CGTCATTGTACCCACC-1	LC_ER-
CGTCATTGTAGACAAA-1	LC_ER-
CGTCATTGTCAACAAT-1	LC_ER-
CGTCATTGTCTTTATG-1	LC_ER+
CGTCATTGTTATGTGG-1	HY_ER+_ER-
CGTCATTGTTTGACCT-1	LC_ER+
CGTCATTGTTTGGCTT-1	LC_ER-
CGTCCTAGTAACTACG-1	LC_ER+
CGTCCTAGTTGCACGG-1	LC_ER+
CGTCCTAGTTTATCTG-1	LC_ER+
CGTGACATCAAACACC-1	LC_ER+
CGTGACATCCCGCATT-1	LC_ER-
CGTGACATCTAAGGAG-1	LC_ER-
CGTGACATCTTAAGTG-1	LC_ER+
CGTGACATCTTGTCTG-1	LC_ER+
CGTGAGGAGCGGTTAT-1	Immature_BC
CGTGAGGAGGTCGATT-1	LC_ER-
CGTGCACAGCAAGACA-1	LC_ER+
CGTGCACAGCTGCACA-1	LC_ER-
CGTGCACAGCTTATGA-1	Immature_BC
CGTGCACAGGGCCATC-1	LC_ER+
CGTGCTGCACACCAAC-1	LC_ER-
CGTGCTGCACCCTCAC-1	LC_ER-
CGTGCTGCATAATCGT-1	LC_ER+
CGTGCTTTCAATGAGG-1	LC_ER+
CGTGCTTTCACCAATA-1	Immature_BC
CGTGCTTTCGTCAAGT-1	LC_ER+
CGTGCTTTCTCATCAT-1	HY_ER+_ER-
CGTGGTTCAAGCTACC-1	LC_ER+
CGTGGTTCATCACAGC-1	LC_ER+
CGTGGTTCATCTAGCA-1	Prolif
CGTGTTACAAGACTCC-1	LC_ER-
CGTGTTACAAGCTTAT-1	Immature_BC
CGTGTTACAAGGAATC-1	LC_ER-
CGTGTTACAGTAAAGC-1	LC_ER+
CGTTAAATCCGCTAGA-1	Immature_BC
CGTTAACAGGAGTCTT-1	LC_ER-
CGTTAACAGTCTCACC-1	LC_ER+
CGTTAGGTCAATACGC-1	LC_ER-
CGTTAGGTCACTCAAA-1	Immature_BC
CGTTAGGTCATGAGCT-1	LC_ER+
CGTTAGGTCATGCAAC-1	LC_ER-
CGTTAGGTCATTAGGC-1	HY_ER+_ER-
CGTTAGGTCGCAGGCT-1	LC_ER+
CGTTAGGTCGTTATAG-1	LC_ER+
CGTTAGGTCTAATTGG-1	Immature_BC
CGTTAGGTCTTTGTAC-1	Immature_BC
CGTTAGTAGCTGCACA-1	LC_ER+
CGTTAGTAGTAAGGGC-1	LC_ER-
CGTTAGTAGTTCCCGT-1	LC_ER+
CGTTATCGTACCAGGT-1	LC_ER-
CGTTATCGTCCTTAGT-1	Immature_BC
CGTTATCGTGTTAAAC-1	HY_BC_ER+
CGTTATCGTTGAGCCG-1	LC_ER-
CGTTATCGTTGGATCA-1	LC_ER+
CGTTATCGTTTATCGC-1	Immature_BC
CGTTATTTCACCAATA-1	LC_ER+
CGTTATTTCGGTTTCC-1	LC_ER-
CGTTATTTCGTGCCTT-1	LC_ER-
CGTTGCAAGACTTACA-1	LC_ER-
CGTTGCGCACGGTTTA-1	LC_ER+
CGTTTCTCAAACTGTT-1	LC_ER-
CGTTTCTCACCTCACC-1	Immature_BC
CGTTTCTCAGCATTAT-1	LC_ER+
CGTTTCTCATCCATCT-1	LC_ER-
CGTTTGGAGGTGTTAC-1	LC_ER-
CGTTTGGAGTAGGATG-1	LC_ER-
CGTTTGGAGTTCCTCA-1	LC_ER-
CTAAAGCTCATGCATA-1	LC_ER+
CTAAAGCTCCTGCGAA-1	LC_ER-
CTAAAGCTCGGCCAGT-1	LC_ER+
CTAAAGCTCGTTAGCG-1	LC_ER+
CTAAAGCTCTAACCAA-1	LC_ER-
CTAAAGCTCTAGCTTT-1	LC_ER+
CTAAAGCTCTTTGTAC-1	LC_ER+
CTAAATGTCAGTGAAG-1	LC_ER+
CTAAATGTCTCAATTC-1	LC_ER-
CTAAATGTCTGTGCAG-1	LC_ER-
CTAACCACAAACTCAT-1	LC_ER-
CTAACCACACCTGTAA-1	LC_ER+
CTAACCACATTCCTGT-1	LC_ER+
CTAACCCTCGTGCCTT-1	Immature_BC
CTAACCTGTACCGTTT-1	Immature_BC
CTAACCTGTCAAGTAT-1	LC_ER+
CTAACCTGTGTTGTGA-1	HY_ER+_ER-
CTAAGGTTCCGTGACA-1	LC_ER+
CTAAGGTTCCTGGTCT-1	Immature_BC
CTAAGTCAGATACTTG-1	LC_ER+
CTAAGTCAGCCATCAG-1	LC_ER-
CTAAGTCAGGGACCTC-1	Prolif
CTAAGTCAGTGAACGA-1	LC_ER-
CTAATAGTCACGTTAA-1	LC_ER-
CTAATAGTCAGGGCCT-1	LC_ER-
CTAATAGTCATCAGTA-1	HY_ER+_ER-
CTAATAGTCATTGACA-1	LC_ER+
CTAATAGTCCTAGTTT-1	LC_ER-
CTAATAGTCCTCACAC-1	LC_ER+
CTAATCCGTATTCGCT-1	LC_ER+
CTAATCGCAGGCCAAA-1	LC_ER+
CTAATCGCAGTAATAG-1	LC_ER-
CTAATCGCATCTTGAG-1	LC_ER+
CTAATCTTCACCAATA-1	LC_ER+
CTAATCTTCACTCAAA-1	HY_ER+_ER-
CTAATGTCAATATGGA-1	LC_ER+
CTAATGTCAGCAAGGC-1	LC_ER-
CTAATGTCAGCATGTC-1	LC_ER+
CTAATGTCAGCCGCTA-1	LC_ER+
CTAATGTCAGCTCAAC-1	LC_ER+
CTAATGTCAGGACACA-1	LC_ER-
CTAATGTCATCAGTAT-1	LC_ER+
CTAATGTCATCCATCT-1	LC_ER+
CTAATTGAGCATTATG-1	Immature_BC
CTAATTGAGTATTGGC-1	LC_ER+
CTAATTGAGTTACCGG-1	HY_ER+_ER-
CTACAACAGGTAAGGC-1	LC_ER-
CTACAACAGGTAGCTT-1	Immature_BC
CTACAACAGTCACCTC-1	LC_ER+
CTACAACAGTCTCACC-1	LC_ER+
CTACAACAGTTATTCC-1	Immature_BC
CTACCGGCACCGGCTA-1	LC_ER+
CTACCGGCATGCATAT-1	LC_ER+
CTACCTCAGACAAGTG-1	LC_ER+
CTACCTCAGAGGGACT-1	LC_ER-
CTACCTCAGCCAGGTC-1	Immature_BC
CTACCTCAGCCTGTTC-1	HY_BC_ER+
CTACCTCAGCTATGAC-1	LC_ER-
CTACCTCAGTATTGGC-1	LC_ER-
CTACCTCAGTCATTTC-1	LC_ER+
CTACGAAGTAGACAAA-1	LC_ER+
CTACGAAGTGAGCAAG-1	LC_ER+
CTACGAAGTGGACCTG-1	LC_ER-
CTACGAAGTGGTTCCC-1	LC_ER+
CTACGAAGTTAGGTTG-1	LC_ER+
CTACTAAAGATACTTG-1	HY_ER+_ER-
CTACTAAAGCAGGTGG-1	LC_ER+
CTACTTAGTATTCGTC-1	LC_ER+
CTACTTAGTGGGTGAA-1	LC_ER-
CTACTTAGTTAGGATT-1	LC_ER+
CTAGATTCAATTAACC-1	LC_ER+
CTAGATTCACAACAGG-1	LC_ER+
CTAGATTCACATTAAC-1	HY_ER+_ER-
CTAGATTCACCTGCTC-1	LC_ER+
CTAGATTCATATAACC-1	LC_ER+
CTAGATTCATGAATAG-1	LC_ER-
CTAGATTCATTGGGAG-1	LC_ER-
CTAGCGGGTAACCTAG-1	Immature_BC
CTAGCGGGTGAGCGAA-1	LC_ER+
CTAGCGGGTTAGGCTA-1	LC_ER-
CTAGCGGGTTAGTGAT-1	LC_ER-
CTAGCTGAGAGCCGGA-1	LC_ER-
CTAGCTGAGCAATAGG-1	LC_ER-
CTAGCTGAGCATGTCG-1	LC_ER+
CTAGCTGAGCGATAGA-1	Immature_BC
CTAGCTGAGCTAATTG-1	Immature_BC
CTAGCTGAGCTCAATA-1	LC_ER+
CTAGCTGAGTAAGGGC-1	LC_ER+
CTAGCTTGTAACGAGG-1	HY_ER+_ER-
CTAGCTTGTAAGCACC-1	LC_ER-
CTAGCTTGTATTCGTC-1	LC_ER+
CTAGCTTGTGGACCTG-1	LC_ER-
CTAGCTTGTGTCACGG-1	LC_ER-
CTAGCTTGTTTGACCT-1	LC_ER+
CTAGGACGTAATCGCA-1	LC_ER+
CTAGGACGTCCTAAGA-1	Immature_BC
CTAGGACGTGCTAGCG-1	LC_ER-
CTAGGACGTGGATTGC-1	LC_ER+
CTAGGACGTTACGCAA-1	LC_ER-
CTAGGACGTTTGGTTC-1	LC_ER+
CTAGGCGGTCCAAATG-1	LC_ER+
CTAGGCGGTTAGTACG-1	LC_ER+
CTAGGCGGTTCCTCCT-1	LC_ER+
CTAGTAATCATGCATA-1	LC_ER-
CTAGTAGGTAATCGTG-1	HY_ER+_ER-
CTAGTAGGTGCTTTAC-1	Immature_BC
CTAGTAGGTTAACGAT-1	LC_ER-
CTAGTAGGTTTGCGCC-1	LC_ER+
CTAGTGAGTAAAGCAA-1	LC_ER+
CTAGTGAGTATTGCAG-1	LC_ER-
CTAGTGAGTGTTAGCA-1	LC_ER+
CTAGTTGCAAGCCACT-1	LC_ER+
CTAGTTGCAATGCCTA-1	LC_ER+
CTAGTTGCACCTGGTG-1	LC_ER-
CTAGTTGCATGAATAG-1	LC_ER+
CTATAACCAACCCTCC-1	LC_ER+
CTATAACCAGAAACGT-1	LC_ER+
CTATAACCAGCTCAAC-1	Immature_BC
CTATAACCAGGATTAA-1	HY_BC_ER+
CTATAACCAGTCTAGC-1	LC_ER+
CTATAACCAGTTATGT-1	Immature_BC
CTATAACCATGGAGGC-1	LC_ER+
CTATGACAGAGAGGCT-1	LC_ER-
CTATGACAGCATTTCT-1	LC_ER-
CTATGACAGGTGAAGC-1	LC_ER-
CTATGACAGTCACTCC-1	LC_ER+
CTATGACAGTTACCGG-1	LC_ER+
CTATGAGGTACCGAAC-1	LC_ER+
CTATGAGGTGTTGCAA-1	LC_ER+
CTATGAGGTTAGGCGT-1	LC_ER-
CTATGAGGTTGGTTCT-1	LC_ER+
CTATGATCAAATACCT-1	LC_ER+
CTATGATCAATATGGA-1	LC_ER+
CTATGGCCAACTGGCT-1	LC_ER+
CTATGGCCAGTAGCCT-1	LC_ER+
CTATGTTTCACAGGAA-1	LC_ER+
CTATGTTTCACTTTAC-1	LC_ER+
CTATGTTTCTGTGCCT-1	LC_ER+
CTATTACTCAAACCTA-1	LC_ER-
CTATTACTCCTGAATA-1	LC_ER-
CTATTACTCTTGCAAA-1	LC_ER+
CTATTACTCTTGTCCA-1	LC_ER+
CTATTGAAGCCTGGTA-1	LC_ER+
CTCAATAAGAGAGGCT-1	LC_ER+
CTCAATAAGCGATACT-1	LC_ER+
CTCACTCAGTATTGGC-1	LC_ER-
CTCAGGATCCTGGTCT-1	LC_ER-
CTCAGGATCGGTTAGT-1	LC_ER+
CTCATCATCAATGAGG-1	LC_ER+
CTCATGACAAGTGAAC-1	HY_ER+_ER-
CTCATGACACTGACCG-1	LC_ER-
CTCATGACAGCATGTC-1	LC_ER+
CTCATGCTCACTAAGC-1	Immature_BC
CTCATGCTCATCCTGC-1	Immature_BC
CTCATGCTCCCTCGCA-1	LC_ER-
CTCATGCTCGGCTATG-1	LC_ER+
CTCATGCTCTCCTCAA-1	LC_ER-
CTCATTAGTATGGTGC-1	HY_BC_ER+
CTCATTAGTTACGCAA-1	LC_ER+
CTCATTGTCGCGACAC-1	LC_ER-
CTCATTGTCTACCTGC-1	LC_ER+
CTCATTGTCTCCATGC-1	LC_ER-
CTCATTGTCTTAGCGG-1	LC_ER+
CTCATTTAGATGGACA-1	LC_ER-
CTCATTTAGATTGAGG-1	LC_ER-
CTCATTTAGCACTTGG-1	LC_ER-
CTCATTTAGGCGCTTA-1	LC_ER+
CTCATTTAGGTGAAGC-1	LC_ER-
CTCATTTAGTCCTGAG-1	Immature_BC
CTCCAAACAACACTTG-1	HY_ER+_ER-
CTCCAACTCATAACCA-1	LC_ER+
CTCCAACTCCCGTTAC-1	LC_ER+
CTCCAACTCCTTGCAC-1	LC_ER+
CTCCAACTCGTTTCCA-1	LC_ER-
CTCCAACTCTTTAGGA-1	LC_ER+
CTCCATCAGCCAGTAT-1	LC_ER+
CTCCATCAGGACCTGC-1	LC_ER-
CTCCATCAGGGATGCG-1	LC_ER+
CTCCATCAGTCTGGGC-1	LC_ER+
CTCCCTGAGCACGTTG-1	LC_ER+
CTCCCTGAGCTCGCTT-1	LC_ER+
CTCCCTGAGTCAATTG-1	LC_ER+
CTCCCTGAGTTAGTTG-1	Immature_BC
CTCCGGACAAGCGAGC-1	LC_ER+
CTCCGGACAATTTGGT-1	LC_ER-
CTCCGGACACACAATT-1	Immature_BC
CTCCGGACACCAACCG-1	LC_ER+
CTCCGGACATAAGTTC-1	LC_ER+
CTCCGGACATGAATCT-1	LC_ER-
CTCCGTCCAATTGACT-1	LC_ER+
CTCCGTCCAATTTAGC-1	Prolif
CTCCGTCCATGGTTAT-1	LC_ER+
CTCCTAATCGTACCGA-1	Immature_BC
CTCCTAATCTGTGCAG-1	LC_ER+
CTCCTAATCTTGTTCG-1	Immature_BC
CTCCTCACAATAAGCA-1	LC_ER-
CTCCTCACACATTGCA-1	LC_ER-
CTCCTCACACCTGCTC-1	LC_ER+
CTCCTGAGTAACCAGC-1	LC_ER-
CTCCTGAGTACCGTAA-1	LC_ER+
CTCCTGAGTGATTTGG-1	LC_ER+
CTCGACAAGCTACTGG-1	LC_ER-
CTCGACAAGTCAATTG-1	HY_ER+_ER-
CTCGACAAGTTAGACC-1	HY_BC_ER+
CTCGCTAGTAATGGCC-1	LC_ER-
CTCGCTAGTCTAACAG-1	LC_ER+
CTCGCTAGTTAGGTGC-1	LC_ER-
CTCGCTCCACAAAGAC-1	Immature_BC
CTCGCTCCAGCGCTTG-1	LC_ER-
CTCGCTCCATCACTTC-1	LC_ER-
CTCGCTCCATCCATCT-1	LC_ER+
CTCGTTATCAGAAACG-1	LC_ER+
CTCGTTATCCTAATAG-1	LC_ER+
CTCGTTATCCTCGATC-1	LC_ER-
CTCGTTATCGAAGTAG-1	LC_ER+
CTCTAAGCAACTGGGA-1	LC_ER+
CTCTAAGCATCAGCAC-1	LC_ER-
CTCTAAGCATCCATCT-1	Immature_BC
CTCTAGCTCATTGACA-1	LC_ER+
CTCTAGCTCTCCTCTT-1	LC_ER-
CTCTATGTCATTAGGC-1	Immature_BC
CTCTATGTCTAGCTTT-1	LC_ER-
CTCTCACAGCTAAAGG-1	LC_ER-
CTCTCACAGGCATGTT-1	Immature_BC
CTCTCACAGGTAAGGC-1	Immature_BC
CTCTCACAGTTTCCGC-1	LC_ER+
CTCTGTTCAACAGGTG-1	LC_ER-
CTCTGTTCACAACCTA-1	LC_ER+
CTCTGTTCACCTACTT-1	LC_ER+
CTCTGTTCACGTAATT-1	LC_ER+
CTCTGTTCAGTATGTT-1	LC_ER-
CTCTGTTCATAGCGGA-1	LC_ER+
CTCTTGATCAAGCTAC-1	LC_ER+
CTCTTGATCCTGCGAA-1	LC_ER+
CTCTTGATCGCTATAA-1	LC_ER-
CTCTTGATCGTGCTTC-1	Immature_BC
CTCTTGATCTACTAAG-1	Prolif
CTGAAACTCCATTACT-1	LC_ER-
CTGAAACTCTTAGCGG-1	HY_ER+_ER-
CTGAATATCGCAATCG-1	LC_ER-
CTGACATAGCAAACCT-1	LC_ER+
CTGACCAAGAAAGGAA-1	HY_ER+_ER-
CTGACCAAGAGGGACT-1	LC_ER+
CTGACCAAGGCGAATA-1	LC_ER+
CTGACCAAGGGCCACT-1	Immature_BC
CTGACCAAGTAGCGGG-1	HY_ER+_ER-
CTGACCAAGTATTGGC-1	LC_ER-
CTGATCACAATAGCAA-1	LC_ER+
CTGATCACATGGCCCA-1	Immature_BC
CTGCAATAGCGAAGTA-1	Immature_BC
CTGCAATAGCGGCTGT-1	LC_ER-
CTGCAATAGGAGGCAT-1	LC_ER-
CTGCTACTCAAACCGT-1	LC_ER+
CTGCTACTCAAATCGC-1	LC_ER+
CTGCTACTCGCCTGTT-1	HY_ER+_ER-
CTGCTACTCTGGCAAT-1	LC_ER+
CTGCTATGTAGGTTAT-1	LC_ER-
CTGCTATGTGCTAGCG-1	LC_ER-
CTGCTATGTGTTTCAC-1	Immature_BC
CTGCTATGTGTTTGTC-1	LC_ER-
CTGCTATGTTCCTGTG-1	LC_ER-
CTGCTCCCAAGGTAAC-1	LC_ER-
CTGCTCCCACGGTTTA-1	Immature_BC
CTGCTCCCATGAGCAG-1	HY_ER+_ER-
CTGCTCCCATTATGAC-1	LC_ER-
CTGCTCCCATTGTGAT-1	LC_ER-
CTGGACCAGAACAAGT-1	LC_ER+
CTGGACCAGCATCCAG-1	LC_ER-
CTGGACCAGGCCCAGT-1	LC_ER+
CTGGACCAGGTGTCCA-1	LC_ER-
CTGGATGTCACCATTT-1	LC_ER+
CTGGATGTCGGTTTGG-1	LC_ER-
CTGGCTAAGACTAAGG-1	LC_ER+
CTGGCTAAGGCAAGTA-1	LC_ER+
CTGGCTAAGGCAGGTG-1	LC_ER+
CTGGCTAAGGCCGGAA-1	LC_ER-
CTGGCTAAGGCGGGTA-1	LC_ER-
CTGGTAAGTACCTTAC-1	LC_ER+
CTGGTAAGTCCCGGAA-1	LC_ER+
CTGGTCAAGGGTTATC-1	LC_ER+
CTGGTTACACATAGCC-1	LC_ER+
CTGGTTACACTTAGGC-1	LC_ER+
CTGGTTTGTAATCCCT-1	LC_ER+
CTGGTTTGTACCGTAA-1	LC_ER+
CTGGTTTGTCACAAAT-1	LC_ER-
CTGTAACAGCCTGATG-1	LC_ER+
CTGTAACAGCTCAATA-1	LC_ER+
CTGTACCTCAGGCCTA-1	LC_ER+
CTGTACCTCCAAGTGT-1	LC_ER+
CTGTACCTCCATAATG-1	LC_ER+
CTGTACCTCCGCCTCA-1	LC_ER+
CTGTACCTCCTTAGTT-1	LC_ER+
CTGTACCTCCTTCGTA-1	Immature_BC
CTGTATTTCAAAGGCA-1	Immature_BC
CTGTATTTCGATTCTT-1	LC_ER-
CTGTGTGAGAAAGGAA-1	LC_ER+
CTGTGTGAGCACAGCC-1	Immature_BC
CTGTGTGAGGACCTCA-1	LC_ER+
CTGTGTGAGGAGCACG-1	LC_ER+
CTGTGTGAGTTGTCAA-1	LC_ER-
CTGTGTGAGTTTGCGG-1	LC_ER-
CTGTTAAAGCCATCAG-1	LC_ER-
CTGTTAAAGTAACGAG-1	Immature_BC
CTGTTCATCATAACCA-1	Immature_BC
CTGTTCATCGGGACTC-1	LC_ER-
CTGTTCATCTTAGGAC-1	LC_ER-
CTGTTGGAGACAGGTA-1	LC_ER-
CTGTTGGAGCAAGGAC-1	Immature_BC
CTGTTGGAGTATGTGC-1	Immature_BC
CTGTTTAGTAAGCTCA-1	LC_ER+
CTGTTTAGTAATCCCT-1	LC_ER+
CTGTTTAGTCAGGCAT-1	LC_ER+
CTGTTTAGTCCTAACT-1	LC_ER+
CTGTTTAGTTACGCGG-1	LC_ER+
CTGTTTAGTTATCCTA-1	LC_ER+
CTGTTTAGTTTGCGCC-1	LC_ER+
CTTAACAAGACACCGC-1	Immature_BC
CTTAACAAGGTTAGAG-1	Immature_BC
CTTAAGATCCAGGGAG-1	LC_ER+
CTTAAGATCCCTCACG-1	LC_ER-
CTTAAGGGTCATAGAT-1	LC_ER-
CTTAAGGGTCCTAATC-1	LC_ER+
CTTAAGGGTTAGAGGG-1	LC_ER-
CTTAATGAGAATGACG-1	LC_ER-
CTTAATGAGACAAGTG-1	LC_ER+
CTTAATGAGCTTAGCG-1	LC_ER+
CTTAATGAGGACCTGC-1	LC_ER-
CTTAATGAGGTTTACA-1	LC_ER+
CTTAATGAGTTAGTGC-1	LC_ER-
CTTACCGGTAATCGCA-1	LC_ER-
CTTACCGGTACCGAAC-1	LC_ER+
CTTACCGGTCAATAGT-1	LC_ER+
CTTACCGGTCATTGTC-1	LC_ER+
CTTACCGGTGAGGTAG-1	LC_ER-
CTTACCGGTTGTCCAT-1	LC_ER+
CTTACCGGTTTCGCGC-1	LC_ER+
CTTACCTCAATTGAGA-1	LC_ER-
CTTACCTCAGACAAAC-1	LC_ER-
CTTACCTCAGTTAAAG-1	LC_ER+
CTTACCTCATAGCTTG-1	LC_ER-
CTTAGGAGTAGGTTAT-1	LC_ER+
CTTAGGAGTCGCAAAC-1	Immature_BC
CTTAGGAGTGACATAT-1	LC_ER-
CTTAGGAGTGCGCATG-1	LC_ER-
CTTAGGAGTGTGCACG-1	LC_ER+
CTTAGTTTCCCTTGCG-1	Immature_BC
CTTATGTTCCCGCAAA-1	LC_ER+
CTTATTGGTGAGACTC-1	Prolif
CTTATTGGTTTGTGGA-1	LC_ER+
CTTCAAGCACAGAACG-1	LC_ER+
CTTCAAGCACCTAATG-1	LC_ER-
CTTCAAGCAGCATGGA-1	LC_ER+
CTTCAAGCATAAGTTC-1	Immature_BC
CTTCAAGCATTAAGTC-1	Immature_BC
CTTCAATTCATGCAAC-1	LC_ER-
CTTCAATTCATGGTTA-1	LC_ER-
CTTCAATTCCTTGCAC-1	LC_ER-
CTTCAATTCGCTATAA-1	Immature_BC
CTTCAATTCTAGCTAA-1	LC_ER+
CTTCAATTCTGGTCCT-1	LC_ER-
CTTCACTCAACTAGCC-1	Immature_BC
CTTCACTCAATGCCTA-1	LC_ER+
CTTCACTCAGGTTATT-1	Immature_BC
CTTCACTCATAAGTCT-1	LC_ER+
CTTCAGGAGACACTTA-1	LC_ER+
CTTCAGGAGCAACATC-1	LC_ER+
CTTCAGGAGCATGCAT-1	LC_ER+
CTTCAGGAGCGATACT-1	LC_ER+
CTTCAGGAGGACAACA-1	LC_ER-
CTTCAGGAGGACTTAC-1	LC_ER-
CTTCAGGAGGCCGGAA-1	LC_ER+
CTTCATCCAATATGGA-1	HY_BC_ER+
CTTCATCCAATTAAGG-1	LC_ER-
CTTCGCGTCAATGTCA-1	Immature_BC
CTTCGCGTCTAATCTC-1	LC_ER-
CTTCGCGTCTCCTCTT-1	LC_ER-
CTTCTAAGTCAGGAAG-1	LC_ER-
CTTCTAAGTTGTTCAC-1	LC_ER+
CTTCTCAAGCATGACT-1	LC_ER-
CTTCTCAAGCTGTAAC-1	LC_ER-
CTTCTCAAGGAGCACG-1	LC_ER-
CTTGAACAGCCTAATA-1	LC_ER+
CTTGAACAGCTTAACA-1	HY_ER+_ER-
CTTGAACAGGAACCGG-1	HY_ER+_ER-
CTTGAACAGTCATCCC-1	LC_ER+
CTTGAATCAAAGCTCC-1	LC_ER+
CTTGAATCACTTGTTC-1	LC_ER+
CTTGACGAGATGGACA-1	Immature_BC
CTTGACGAGCGCATTG-1	LC_ER-
CTTGACGAGCTCAAAC-1	LC_ER+
CTTGACGAGGTCAAAG-1	LC_ER-
CTTGACGAGTTAGAGG-1	Immature_BC
CTTGCAACACAAACTT-1	Immature_BC
CTTGCAACACTAAATC-1	LC_ER-
CTTGCAACACTGGCTG-1	LC_ER-
CTTGCAACATCAATCG-1	LC_ER+
CTTGCAACATCCCTCA-1	LC_ER+
CTTGCATGTAGTAAGA-1	LC_ER+
CTTGCATGTGCAATGC-1	LC_ER+
CTTGCATGTTTACGTC-1	LC_ER-
CTTGCGCGTAAAGCGG-1	LC_ER+
CTTGCGCGTGAAACAA-1	HY_ER+_ER-
CTTGCGCGTTCACCCA-1	LC_ER+
CTTGCTCAGAACCTAC-1	LC_ER+
CTTGCTCAGGACAATG-1	Immature_BC
CTTGCTCAGGCCAATT-1	Immature_BC
CTTGGACCACAGAACG-1	Prolif
CTTGGACCATCGTTCT-1	LC_ER-
CTTGGACCATTAAAGG-1	HY_BC_ER+
CTTGTAAAGAATGACG-1	LC_ER+
CTTGTAAAGGGACGCA-1	LC_ER+
CTTGTAAAGGGTCCAC-1	LC_ER+
CTTGTAAAGGGTGGAT-1	LC_ER-
CTTGTAAAGGTCAAAG-1	LC_ER-
CTTGTAAAGTAACAGG-1	LC_ER-
CTTGTCCAGCCTGGTA-1	HY_ER+_ER-
CTTGTCCAGTTTAACG-1	LC_ER-
CTTGTTCCAAACTGTT-1	Immature_BC
CTTGTTCCACGTAAGG-1	LC_ER-
CTTGTTCCATCATGTG-1	LC_ER-
CTTGTTTAGCCGGTAC-1	LC_ER-
CTTGTTTAGGTCTTGG-1	LC_ER-
CTTGTTTAGGTGAAAT-1	HY_ER+_ER-
CTTGTTTAGTTTAACG-1	LC_ER+
CTTTAGGCAAGCTAAA-1	HY_ER+_ER-
CTTTAGTTCAGCAAGA-1	Immature_BC
CTTTAGTTCAGCACCA-1	LC_ER-
CTTTAGTTCGCTAGAT-1	LC_ER+
CTTTATCAGCGCCTTT-1	LC_ER-
CTTTATCAGGTCCGTA-1	LC_ER-
CTTTATCAGGTCCTGA-1	LC_ER-
CTTTATCAGTTAGTGC-1	LC_ER+
CTTTATGGTGGATTAT-1	LC_ER-
CTTTCTTGTAATGGCC-1	LC_ER+
CTTTCTTGTCCTTCAG-1	Immature_BC
CTTTGAGCAGACAAAC-1	LC_ER-
CTTTGAGCATCCATCT-1	LC_ER+
CTTTGGGAGCGTGCAC-1	LC_ER-
CTTTGGGAGGTTTACA-1	LC_ER+
CTTTGGGAGTAGCGGG-1	LC_ER+
CTTTGGGAGTGAACAG-1	LC_ER+
CTTTGGTGTAACAGGG-1	LC_ER+
CTTTGGTGTTAGTGAT-1	LC_ER-
CTTTGGTGTTGAAGCC-1	LC_ER+
CTTTGTCCAATTGAAG-1	LC_ER-
CTTTGTCCAGCATGGA-1	Prolif
CTTTGTCCAGGTTCAC-1	LC_ER+
CTTTGTCCAGTAGGTG-1	Immature_BC
CTTTGTCCATTGTTGG-1	LC_ER-
CTTTGTCCATTTAAGC-1	LC_ER-
GAAACCCGTGTAACCA-1	LC_ER-
GAAACCCGTTCATTTG-1	LC_ER+
GAAACCCGTTCCTCCT-1	Immature_BC
GAAACTGAGAGAGGCT-1	LC_ER-
GAAACTGAGCCTGATG-1	Immature_BC
GAAAGCCAGTAGCTTA-1	HY_BC_ER+
GAAAGGCTCAAGCGCC-1	LC_ER+
GAAAGGCTCCTCATGC-1	LC_ER-
GAAAGGCTCCTGGCTT-1	HY_ER+_ER-
GAACACAAGCTATATG-1	LC_ER+
GAACACAAGGACCTTG-1	LC_ER+
GAACACAAGGTGCTGC-1	Immature_BC
GAACACAAGGTTTACA-1	Prolif
GAACACAAGTTATCCT-1	HY_BC_ER+
GAACCAAAGCATTAGC-1	LC_ER-
GAACCAAAGCCAAATC-1	Immature_BC
GAACCAAAGCCTGACA-1	LC_ER+
GAACCAAAGCGCAATT-1	LC_ER+
GAACCAAAGGCCTTAG-1	LC_ER+
GAACCAAAGTGAACGA-1	LC_ER+
GAACCGCTCATAGCCG-1	HY_ER+_ER-
GAACCGCTCTCACATT-1	LC_ER-
GAACCTTAGGCTACAT-1	LC_ER+
GAACCTTAGTTAGGCT-1	LC_ER+
GAACGAATCAACCAAC-1	LC_ER-
GAACGAATCAGTATTG-1	Immature_BC
GAACGAATCCAAACAC-1	LC_ER+
GAACTTATCACCAATA-1	LC_ER-
GAACTTATCCCGTTGT-1	LC_ER-
GAACTTATCCGCCTCA-1	Immature_BC
GAACTTATCCTTCGTA-1	LC_ER+
GAACTTATCGATATTG-1	LC_ER-
GAACTTATCTTTGAGA-1	LC_ER-
GAAGCCTGTGTAATAC-1	LC_ER+
GAAGCCTGTGTTCCCA-1	LC_ER-
GAAGCCTGTTCCATTA-1	LC_ER+
GAAGCCTGTTGGGTTA-1	HY_ER+_ER-
GAAGCCTGTTGTCCAT-1	LC_ER+
GAAGCTAAGATGGAGC-1	LC_ER+
GAAGCTAAGCAAGGAC-1	LC_ER+
GAAGCTAAGGCTTAAC-1	LC_ER+
GAAGCTAAGTATTGTG-1	Immature_BC
GAAGCTAAGTTCCCGT-1	LC_ER-
GAAGGAACACGTAATT-1	LC_ER-
GAAGGAACATGCATAT-1	LC_ER+
GAAGGATGTCATCAAG-1	Immature_BC
GAAGGATGTGACCTGG-1	LC_ER-
GAAGGCCCACCCACAG-1	Immature_BC
GAAGGCCCACCTACTT-1	Immature_BC
GAAGGCCCATAAGTTC-1	LC_ER+
GAAGGCTAGCACAGGG-1	LC_ER+
GAAGGCTAGCCATCAG-1	Immature_BC
GAAGGCTAGCTCAATA-1	LC_ER+
GAAGGCTAGTTGTCCC-1	LC_ER+
GAAGTAAGTAGGTTTG-1	Immature_BC
GAAGTAAGTCCTCCAA-1	LC_ER-
GAAGTAAGTGAATCGC-1	Immature_BC
GAAGTAAGTGTTTGTC-1	LC_ER+
GAAGTATAGCAAGGGT-1	LC_ER-
GAAGTATAGGAACGCG-1	LC_ER+
GAAGTATAGGCTTAGT-1	Immature_BC
GAAGTATAGTCGCTAG-1	LC_ER+
GAAGTCAAGAATCTCA-1	LC_ER+
GAAGTCAAGCTGGAAA-1	LC_ER+
GAAGTCAAGTAACGGA-1	LC_ER-
GAAGTGATCATTACAG-1	LC_ER+
GAAGTGATCCTTGCGT-1	LC_ER-
GAAGTGATCTTGCATT-1	LC_ER-
GAATTTGTCATTGTTC-1	Immature_BC
GAATTTGTCTGGCAAT-1	LC_ER-
GACAATACATTCCTGT-1	Immature_BC
GACACCGGTATTACCC-1	LC_ER-
GACACCGGTCAAGACC-1	LC_ER+
GACACCGGTCGTAATG-1	LC_ER-
GACACCGGTGGGTACT-1	LC_ER-
GACACCGGTTGCGGAT-1	LC_ER-
GACATAGAGACCATAC-1	LC_ER+
GACATAGAGCGATACT-1	LC_ER-
GACATAGAGTAAGTCC-1	LC_ER-
GACATAGAGTCATTTC-1	LC_ER+
GACATTATCTAGCTTT-1	Immature_BC
GACCGAACATTGGGAG-1	LC_ER-
GACCGTTCAAACAACA-1	LC_ER+
GACCGTTCAGGCCTTG-1	Immature_BC
GACCGTTCATGGCCTG-1	LC_ER+
GACCTAAGTACAATGT-1	LC_ER+
GACCTAAGTGGACCTG-1	LC_ER-
GACCTAAGTGTGTCCC-1	LC_ER-
GACCTAAGTTCCATTA-1	LC_ER-
GACCTAGTCATGAAGG-1	LC_ER-
GACCTAGTCGAAGTAG-1	LC_ER-
GACCTAGTCGGTAACT-1	HY_ER+_ER-
GACCTCAAGACCATAC-1	LC_ER+
GACCTCAAGCGGTTAT-1	Immature_BC
GACCTGATCATGCATA-1	LC_ER-
GACCTGATCCAACTGG-1	LC_ER+
GACCTGATCCTCAGCT-1	Immature_BC
GACCTGATCGCGCTAA-1	LC_ER-
GACCTGATCTAACCTT-1	LC_ER-
GACCTGCAGGCCATCA-1	LC_ER-
GACCTGCAGTAATCCA-1	LC_ER-
GACCTGCAGTCCTTTG-1	LC_ER-
GACCTTTGTGCGCATG-1	Immature_BC
GACGCAACATTGCGTA-1	Immature_BC
GACGTAAAGCAAGATG-1	LC_ER-
GACGTAAAGTCAATCA-1	LC_ER+
GACTAATGTTTGAGGC-1	LC_ER+
GACTCACCAAATTCGT-1	LC_ER-
GACTCACCAATCATGT-1	Immature_BC
GACTCACCACGTAATT-1	LC_ER+
GACTCACCATCGTTCT-1	LC_ER-
GACTCACCATGCTTAG-1	LC_ER+
GACTTACAGCGTGCGT-1	LC_ER+
GACTTACAGCTTAGCG-1	LC_ER+
GACTTACAGGGACCTC-1	LC_ER+
GACTTACAGGTCCGTA-1	LC_ER-
GACTTACAGTAGCGCC-1	LC_ER+
GACTTAGGTACCGGAT-1	LC_ER-
GACTTAGGTGGACCTG-1	LC_ER+
GACTTAGGTTAGGATT-1	LC_ER-
GACTTGGTCAATCATG-1	HY_ER+_ER-
GACTTGGTCCCTCTAA-1	LC_ER-
GACTTGGTCCTAATTC-1	LC_ER-
GACTTGGTCGGGACCT-1	LC_ER+
GACTTGGTCTAGCGAT-1	LC_ER-
GAGAAACGTAAATTGC-1	LC_ER+
GAGAAACGTACCGGAT-1	LC_ER-
GAGAAACGTTCACCCA-1	LC_ER+
GAGAAACGTTGTAACG-1	LC_ER-
GAGAACCAGTCAGTAC-1	LC_ER-
GAGAGGCGTCGCAAAC-1	LC_ER+
GAGAGGCGTGGATTAT-1	Immature_BC
GAGAGGCGTGTTAGCA-1	Immature_BC
GAGATAAGTGGTTCTT-1	LC_ER+
GAGATAAGTTCAAGCA-1	LC_ER+
GAGCAAATCACTAGGT-1	HY_BC_ER+
GAGCAAATCATTGCGG-1	LC_ER+
GAGCAAATCCGCCTAT-1	HY_ER+_ER-
GAGCAAATCGCTAGAT-1	LC_ER+
GAGCAAATCGGGCCAT-1	Immature_BC
GAGCAAATCTAATTGG-1	LC_ER-
GAGCAAGGTAAAGCAA-1	LC_ER-
GAGCAAGGTCATCAAG-1	HY_ER+_ER-
GAGCATGCAAAGCTCC-1	LC_ER+
GAGCCACTCAAGTGTC-1	LC_ER-
GAGCCACTCACTAAGC-1	LC_ER-
GAGCCACTCTCCTCAA-1	LC_ER-
GAGCCTTCAAAGCCTC-1	LC_ER+
GAGCCTTCAGGATAAC-1	LC_ER+
GAGCCTTCAGGCGATA-1	LC_ER+
GAGCGAAGTATTGTGG-1	LC_ER-
GAGCGAAGTGCTGTAA-1	LC_ER-
GAGCGATAGACTCGCA-1	LC_ER-
GAGCGATAGCACTAGT-1	LC_ER+
GAGCGATAGGCTACAT-1	Immature_BC
GAGCGATAGTTCCCGT-1	LC_ER+
GAGCGATAGTTCCTGC-1	LC_ER-
GAGCGGTCAACACCTA-1	Immature_BC
GAGCGGTCATCGCTTT-1	Immature_BC
GAGCGGTCATGTCGCG-1	LC_ER-
GAGCTAGCAAACCCTA-1	HY_BC_ER+
GAGCTAGCAAGGTACG-1	LC_ER+
GAGCTAGCACCAAAGG-1	LC_ER-
GAGCTGCTCAGCAAGA-1	LC_ER+
GAGCTGCTCCAAACAC-1	LC_ER-
GAGCTGCTCCTCAGCT-1	LC_ER-
GAGCTGCTCCTCATGC-1	LC_ER-
GAGCTGCTCCTTAGGG-1	LC_ER+
GAGCTGCTCTCGCCCA-1	LC_ER+
GAGCTTAGTTGTAAAC-1	LC_ER-
GAGCTTAGTTTACTTG-1	Immature_BC
GAGCTTGTCACAAGCT-1	LC_ER+
GAGCTTGTCGGTCATG-1	HY_ER+_ER-
GAGCTTGTCGTCCTTA-1	LC_ER-
GAGGACTAGACACTTA-1	LC_ER-
GAGGACTAGCCTGTTC-1	LC_ER-
GAGGACTAGCTTCTCA-1	LC_ER+
GAGGACTAGGACTTAC-1	LC_ER-
GAGGACTAGTCACGAT-1	LC_ER-
GAGGACTAGTTAGCCG-1	LC_ER+
GAGGAGGCAAACGGGC-1	HY_ER+_ER-
GAGGAGGCAGCAAGGC-1	Immature_BC
GAGGAGGCATAATGTC-1	LC_ER-
GAGGAGGCATGCAACC-1	HY_ER+_ER-
GAGGAGGCATTATGAC-1	LC_ER-
GAGGCAAGTATTGAGT-1	LC_ER+
GAGGCAAGTTTATCTG-1	LC_ER+
GAGGCCTTCCCTCATA-1	LC_ER+
GAGGCCTTCGTCATTT-1	LC_ER+
GAGGCCTTCTAAATCG-1	LC_ER-
GAGGCCTTCTAGCGTG-1	HY_ER+_ER-
GAGGCTACAGTCTATG-1	LC_ER-
GAGGCTACAGTTATCG-1	Immature_BC
GAGGCTACAGTTTACG-1	HY_BC_ER+
GAGGCTACATGAATAG-1	LC_ER-
GAGGCTTGTTAGCCAA-1	LC_ER+
GAGGCTTGTTGGATCA-1	LC_ER+
GAGGGAGCATAATGTC-1	HY_ER+_ER-
GAGGGAGCATCAGCAC-1	LC_ER-
GAGGTACAGAGCCGCT-1	Immature_BC
GAGGTACAGGAGTCGG-1	LC_ER+
GAGGTACAGGCGAATA-1	LC_ER-
GAGGTACAGTTTCCGC-1	LC_ER+
GAGGTAGGTCCTAACT-1	Immature_BC
GAGGTAGGTTACTAGG-1	LC_ER-
GAGGTAGGTTCACCAT-1	LC_ER-
GAGGTAGGTTGCACGG-1	LC_ER-
GAGGTGAGTGTTGCAA-1	LC_ER-
GAGGTGAGTTAATGAC-1	LC_ER-
GAGGTGAGTTGGATCA-1	LC_ER+
GAGGTTAAGCGAGCGA-1	LC_ER-
GAGGTTAAGCTTTGTT-1	LC_ER-
GAGGTTAAGGCAGGTG-1	Immature_BC
GAGGTTAAGGTAAGCA-1	LC_ER+
GAGGTTAAGTAAGTGG-1	LC_ER-
GAGGTTAAGTCAATTG-1	LC_ER+
GAGGTTAAGTTCCTCA-1	LC_ER-
GAGTAACCAAACATAG-1	LC_ER-
GAGTAACCAGGTTACC-1	LC_ER+
GAGTAACCATAAGGAC-1	LC_ER-
GAGTAACCATGTTGCA-1	Immature_BC
GAGTAATAGTTAGTGC-1	LC_ER-
GAGTAATAGTTTCCGC-1	LC_ER+
GAGTATCTCAAGTGTC-1	LC_ER+
GAGTATCTCAGGCCTA-1	LC_ER+
GAGTATCTCTCACAAA-1	LC_ER+
GAGTATCTCTCACTCA-1	LC_ER-
GAGTATCTCTTGATGA-1	LC_ER+
GAGTCAAAGCTGAGGG-1	LC_ER-
GAGTCAAAGGATTGAG-1	LC_ER+
GAGTCATTCATGCCTC-1	HY_ER+_ER-
GAGTCATTCCGGCTAA-1	LC_ER-
GAGTCATTCGCTCCAT-1	LC_ER+
GAGTGAGGTATTACCC-1	LC_ER+
GAGTGAGGTGCTCCAC-1	LC_ER-
GAGTGAGGTTGTGATG-1	LC_ER-
GAGTGATCAACCTAAT-1	LC_ER-
GAGTGATCACAACCTA-1	Immature_BC
GAGTGATCAGGCAAGC-1	HY_ER+_ER-
GAGTGATCAGGGAGGA-1	LC_ER-
GAGTGATCAGTCTAAT-1	LC_ER-
GAGTGATCAGTTATCG-1	HY_BC_ER+
GAGTGTTTCCAGCACA-1	LC_ER-
GAGTGTTTCTCAATGA-1	Immature_BC
GAGTGTTTCTTACTCG-1	LC_ER-
GAGTTACTCAGGCTAT-1	LC_ER-
GAGTTACTCATGTTTC-1	Immature_BC
GAGTTACTCGATAACC-1	Immature_BC
GAGTTACTCGGCCATA-1	LC_ER+
GAGTTACTCTAAGGAG-1	LC_ER+
GAGTTGCGTGCATCGG-1	LC_ER-
GAGTTGCGTTCCAGGG-1	LC_ER-
GAGTTGCGTTCCGGCT-1	LC_ER+
GAGTTGCGTTCGCTTG-1	Immature_BC
GAGTTTGGTCGTAAAT-1	LC_ER+
GAGTTTGGTCTCAGCC-1	LC_ER+
GAGTTTGGTGCGCAAT-1	Immature_BC
GAGTTTGGTTACAAAC-1	LC_ER-
GAGTTTGGTTGCATCT-1	LC_ER-
GAGTTTGGTTGTAAAC-1	LC_ER+
GATAAAGGTAACGTGC-1	LC_ER+
GATAAAGGTGTAACCA-1	LC_ER+
GATAAAGGTTGTTGTC-1	LC_ER+
GATAAAGGTTTATCGC-1	LC_ER+
GATAACGAGACTATTG-1	LC_ER-
GATAACGAGGCTAGAA-1	HY_ER+_ER-
GATAACGAGGCTTAGT-1	LC_ER-
GATAAGCCAACATAAG-1	LC_ER-
GATAAGCCAACTCGCG-1	LC_ER+
GATAAGCCATAATCGT-1	LC_ER+
GATAAGCCATCACTTC-1	LC_ER+
GATAATCGTCACCAAA-1	LC_ER+
GATAATCGTCATCAAG-1	LC_ER+
GATAATCGTTTATGGG-1	LC_ER+
GATAGACCAAGCTACC-1	LC_ER+
GATAGACCAATTTAGC-1	LC_ER-
GATAGACCAGAGGCTA-1	LC_ER-
GATAGACCATCCCTCA-1	Immature_BC
GATCAAGAGACAAACG-1	LC_ER+
GATCAAGAGGAGTCTT-1	LC_ER-
GATCAAGAGGGTCCAC-1	LC_ER+
GATCAAGAGTTTGGTA-1	LC_ER-
GATCACTAGGAACGGT-1	LC_ER-
GATCACTAGTTTCCGC-1	HY_ER+_ER-
GATCAGGCAACTAGGG-1	LC_ER-
GATCAGGCATTGTCAG-1	HY_ER+_ER-
GATCAGTTCACCTGCT-1	Immature_BC
GATCAGTTCACTCGCT-1	LC_ER-
GATCAGTTCCCGCAAA-1	LC_ER+
GATCAGTTCCGCATGA-1	LC_ER-
GATCCGTCAATTATGC-1	LC_ER-
GATCCGTCAGCTTACA-1	LC_ER-
GATCCGTCATAAGTTC-1	Immature_BC
GATCCGTCATAGTCAT-1	Immature_BC
GATCCGTCATTGCGAC-1	HY_ER+_ER-
GATCGAGCACCTGCCT-1	HY_BC_ER+
GATCGAGCACTAAGCC-1	LC_ER-
GATCGAGCAGCCTGCA-1	LC_ER-
GATCGATTCACTCGCT-1	LC_ER-
GATCGATTCCCTGGTT-1	LC_ER-
GATCGATTCCTTAGGG-1	LC_ER-
GATCGATTCTAATTGG-1	LC_ER+
GATCGATTCTTTGTAC-1	LC_ER-
GATCGCTCAGAATGAC-1	HY_ER+_ER-
GATGACTTCAGGCTAT-1	Immature_BC
GATGACTTCCCGAAGC-1	LC_ER-
GATGACTTCCTGATTT-1	LC_ER+
GATGACTTCGTTAAGC-1	LC_ER+
GATGACTTCGTTTCCA-1	Immature_BC
GATGACTTCGTTTCTG-1	Immature_BC
GATGACTTCTACCTAT-1	LC_ER-
GATGAGGGTCGAAGTC-1	LC_ER-
GATGAGGGTGGTTAGC-1	Immature_BC
GATGCAGCAATTATGC-1	LC_ER-
GATGCAGCATCGCTCC-1	LC_ER+
GATGCATTCAGGTTTA-1	LC_ER+
GATGCATTCTTAGCGG-1	HY_ER+_ER-
GATGCGACAATTATGC-1	LC_ER-
GATGCGACATAACGGG-1	Immature_BC
GATGCGACATCTTGAG-1	LC_ER-
GATGCTTAGCGATAGA-1	Immature_BC
GATGCTTAGGCTGTCA-1	LC_ER+
GATGGACAGGAACGGT-1	LC_ER+
GATGGCTGTTCAAGAT-1	LC_ER-
GATGGCTGTTGTAACG-1	LC_ER+
GATTAAGCAATAACGA-1	Immature_BC
GATTAAGCATCCATCT-1	LC_ER-
GATTACGGTCCTTTAA-1	Immature_BC
GATTACGGTGTGTGGT-1	LC_ER-
GATTACGGTTAATGAC-1	HY_BC_ER+
GATTAGCTCAAACTCA-1	LC_ER-
GATTAGCTCAAGCCTG-1	LC_ER+
GATTAGCTCATAGACC-1	LC_ER-
GATTAGCTCCATAATG-1	LC_ER+
GATTAGTGTGTAATAC-1	LC_ER+
GATTAGTGTTACGCAA-1	LC_ER+
GATTAGTGTTCATTTG-1	LC_ER-
GATTATGTCAAGTGTC-1	LC_ER+
GATTATGTCTTTGTAC-1	LC_ER+
GATTCAATCAAGCGCC-1	LC_ER-
GATTCAATCATCACTT-1	LC_ER+
GATTCAATCATCCTGC-1	LC_ER+
GATTCAATCATTTGTC-1	LC_ER+
GATTCAATCCAGCACA-1	LC_ER-
GATTCAATCGAGCAAA-1	LC_ER-
GATTCAATCTCTAGCC-1	LC_ER+
GATTCAATCTTAAGTG-1	LC_ER+
GATTCAGGTCATAACG-1	HY_BC_ER+
GATTCAGGTTTAGCGA-1	LC_ER+
GATTCATCAATAGCAA-1	LC_ER+
GATTCATCAGCAAATA-1	LC_ER-
GATTCCTGTATTCGTC-1	LC_ER+
GATTCCTGTGGTGAGA-1	LC_ER+
GATTCCTGTGTCCAAA-1	LC_ER+
GATTCCTGTGTGTCCC-1	Prolif
GATTCGCCAAGGTGCA-1	LC_ER-
GATTCGCCAATAATCC-1	LC_ER-
GATTCGCCAATCCCTT-1	LC_ER+
GATTCGCCACAGCCTG-1	Immature_BC
GATTCGCCACCGGTAT-1	LC_ER-
GATTGATGTCTTGCAT-1	LC_ER+
GATTGATGTTACAAAC-1	LC_ER+
GATTGCAGTCGCAATA-1	LC_ER-
GATTGCAGTTCACCCA-1	LC_ER-
GATTGCAGTTGGTGAC-1	Immature_BC
GATTGCAGTTGTTCAC-1	LC_ER+
GATTGCGTCATCCTGC-1	LC_ER-
GATTGCGTCATGTTTC-1	LC_ER-
GATTGCGTCGATCAGT-1	Prolif
GATTGCGTCGCAACAT-1	LC_ER-
GATTGCGTCTCTAGCC-1	LC_ER-
GATTGGCGTTACATCC-1	LC_ER+
GATTGGCGTTATCGAG-1	LC_ER-
GATTGGCGTTGGATAT-1	Immature_BC
GATTGGTTCCTAGTCC-1	HY_ER+_ER-
GATTGGTTCCTGAATA-1	Immature_BC
GATTGGTTCGCGACAC-1	LC_ER+
GATTGGTTCGCGCTAA-1	LC_ER-
GATTGGTTCTAGCGTG-1	LC_ER+
GATTGGTTCTATCGCC-1	LC_ER+
GATTGGTTCTGCAACG-1	LC_ER-
GATTGGTTCTTGAGCG-1	LC_ER-
GATTGTTCACCTAAGC-1	LC_ER+
GATTGTTCAGCTTACA-1	LC_ER+
GATTTGCAGCATTAGC-1	LC_ER+
GATTTGCAGCTCCTTA-1	LC_ER+
GATTTGCAGGTTTGCG-1	LC_ER-
GCAAACAAGCAACATC-1	LC_ER+
GCAAACAAGCTTATGA-1	LC_ER-
GCAAACCGTAACCAGC-1	HY_ER+_ER-
GCAAACCGTACCGGAT-1	LC_ER-
GCAAACCGTTGCCTCA-1	LC_ER+
GCAAACCGTTTACGTC-1	LC_ER+
GCAAACTTCAATTACG-1	LC_ER+
GCAAACTTCACTAATG-1	LC_ER+
GCAAACTTCCCGTTAC-1	LC_ER-
GCAAACTTCCCTGACT-1	LC_ER+
GCAAACTTCCTGAATA-1	HY_ER+_ER-
GCAAACTTCGCAACAT-1	HY_ER+_ER-
GCAAACTTCTTGCATT-1	LC_ER-
GCAAACTTCTTGGATA-1	LC_ER-
GCAACAGCACTCAACA-1	LC_ER-
GCAACAGCACTTAGGC-1	HY_ER+_ER-
GCAACAGCAGGAAGCC-1	Immature_BC
GCAAGCCTCAGCCAAT-1	LC_ER-
GCAAGCCTCGCTAGCA-1	LC_ER-
GCAAGTCGTCCTAATC-1	LC_ER-
GCAAGTCGTGCCTCAC-1	LC_ER-
GCAAGTCGTGGGAACA-1	LC_ER+
GCAAGTGCAGCTACGT-1	LC_ER+
GCAAGTGCAGGGAGGA-1	LC_ER-
GCAATAGAGAACCTGT-1	LC_ER-
GCAATAGAGAGAGCCG-1	LC_ER-
GCAATAGAGCAAGGAC-1	LC_ER+
GCAATAGAGGTGAAAT-1	LC_ER-
GCAATATGTGGAGCAA-1	LC_ER+
GCAATATGTTGTAAAC-1	LC_ER+
GCAATCTAGCGCCTAA-1	HY_ER+_ER-
GCAATCTAGCGCCTTT-1	LC_ER-
GCAATCTAGCTGGCTA-1	LC_ER+
GCAATCTAGCTTACTT-1	LC_ER-
GCAATGAAGCCTGACA-1	LC_ER+
GCAATGAAGCTAAAGG-1	LC_ER-
GCAATGAAGGTCAAAG-1	LC_ER+
GCAATGAAGTGATTCA-1	LC_ER-
GCAATGAAGTTGTCAA-1	LC_ER+
GCAATGTTCAATGTGC-1	LC_ER+
GCAATGTTCAGCAAAG-1	LC_ER+
GCAATGTTCCTAGTAA-1	Immature_BC
GCAATGTTCGCCTGTT-1	LC_ER-
GCAATGTTCGGTAACT-1	LC_ER+
GCAATGTTCGGTTTCC-1	LC_ER+
GCAATGTTCTGTTCAT-1	Immature_BC
GCACATTAGACTAAGG-1	LC_ER+
GCACATTAGCTCCCTG-1	LC_ER-
GCACATTAGCTTTGTT-1	LC_ER+
GCACATTAGGAAGCTA-1	LC_ER+
GCACATTAGGACAACA-1	LC_ER-
GCACATTAGGCATTGT-1	LC_ER+
GCACCTAAGCTAATCA-1	LC_ER-
GCACCTAAGGATTGCT-1	LC_ER+
GCACCTAAGTCATGCG-1	LC_ER+
GCACGAACAAGGGTTG-1	Immature_BC
GCACGAACACCTCACC-1	LC_ER-
GCACGAACACGAATCC-1	LC_ER-
GCACGAACAGCATGGA-1	LC_ER+
GCACGAACATAAGTTC-1	LC_ER-
GCACGCTAGAAAGCAT-1	LC_ER+
GCACGCTAGAGGAGTC-1	LC_ER-
GCACGCTAGCTAAAGG-1	Immature_BC
GCACGCTAGGAAGCTA-1	LC_ER+
GCACGCTAGTATTGGC-1	LC_ER-
GCACGCTAGTCATGCG-1	LC_ER-
GCACGGTTCATAACGC-1	Immature_BC
GCACGGTTCCTCATCA-1	LC_ER-
GCACGGTTCGATTTAG-1	LC_ER+
GCACGGTTCGCTAAGT-1	LC_ER-
GCACGGTTCGCTCCAT-1	LC_ER+
GCACTAAGTAACGGGA-1	HY_ER+_ER-
GCACTAAGTAATGGCC-1	LC_ER+
GCACTAAGTCAATGTG-1	LC_ER+
GCACTAAGTTACCTGT-1	LC_ER-
GCACTAAGTTGGTTCT-1	LC_ER-
GCACTAAGTTTCGCGC-1	LC_ER+
GCACTTACAAACTAAG-1	Immature_BC
GCACTTACAACCCTCC-1	LC_ER-
GCACTTACAATTGCGC-1	LC_ER+
GCACTTACACCTAATG-1	LC_ER+
GCACTTACAGAACCGA-1	LC_ER-
GCACTTACAGCAACCT-1	HY_BC_ER+
GCACTTACAGCATGAG-1	LC_ER-
GCACTTACAGCATTAT-1	LC_ER-
GCACTTACATAAACCT-1	LC_ER-
GCAGCAACAATTAACC-1	LC_ER-
GCAGCAACACATGCTA-1	LC_ER+
GCAGCAACACGAATCC-1	LC_ER+
GCAGCAACAGCATGTC-1	LC_ER+
GCAGCCAGTACGCGCA-1	HY_ER+_ER-
GCAGCCAGTCAAGTGC-1	LC_ER+
GCAGCCAGTGCCTCAC-1	LC_ER+
GCAGCTATCAGCACGC-1	LC_ER+
GCAGCTATCCAAGTGT-1	LC_ER-
GCAGCTATCCCTGTTA-1	LC_ER+
GCAGCTATCCGGCTAA-1	LC_ER-
GCAGCTATCCGGTTGA-1	LC_ER-
GCAGCTATCCTGAATA-1	LC_ER-
GCAGCTATCTGTAATG-1	LC_ER-
GCAGCTATCTTTGAGA-1	LC_ER-
GCAGGAAGTAATGACT-1	LC_ER+
GCAGGAAGTAGGTTGC-1	LC_ER-
GCAGGAAGTCATAGAT-1	LC_ER+
GCAGGAAGTGCCGCAA-1	LC_ER+
GCAGGAAGTGGAAGGC-1	Immature_BC
GCAGGAAGTGTCCAGG-1	Immature_BC
GCAGGACCATTAAGCT-1	LC_ER+
GCAGGATAGAGGAGTC-1	Immature_BC
GCAGGATAGGGATGAC-1	LC_ER+
GCAGGATAGTTCCTCA-1	LC_ER+
GCAGGCAAGAGGAAGG-1	LC_ER-
GCAGGCAAGCCTAACG-1	LC_ER+
GCAGGCAAGCCTTAAA-1	Immature_BC
GCAGGCAAGCGGGCAA-1	LC_ER+
GCAGGCAAGGCATTAC-1	LC_ER+
GCAGGCAAGGGATTAG-1	Immature_BC
GCAGGCAAGGTATTGC-1	Immature_BC
GCAGGCTTCAATGTGC-1	LC_ER-
GCAGGCTTCCTAGTTT-1	LC_ER+
GCAGGCTTCCTTCGTA-1	LC_ER-
GCAGGCTTCTAACTGA-1	LC_ER-
GCAGGTGAGACAAAGT-1	LC_ER+
GCAGGTGAGACAGGCG-1	LC_ER+
GCAGGTGAGCACGATT-1	LC_ER-
GCAGGTGAGCTGAGGG-1	LC_ER+
GCAGGTGAGGCACAGG-1	Immature_BC
GCAGGTGAGGCGCACT-1	LC_ER+
GCAGGTGAGGGCTTAT-1	LC_ER-
GCAGGTGAGTGCACGC-1	LC_ER+
GCAGGTTGTAAATTGC-1	LC_ER+
GCAGGTTGTCAGTAAT-1	LC_ER-
GCAGGTTGTGAATCGC-1	LC_ER+
GCAGGTTGTTAAATGC-1	LC_ER-
GCATATATCAAACACC-1	LC_ER-
GCATATATCAATGAGG-1	Immature_BC
GCATATATCATGAGCT-1	LC_ER-
GCATATATCATGCCTC-1	LC_ER+
GCATATATCCGTCCAT-1	HY_ER+_ER-
GCATATATCTGCAAGT-1	LC_ER-
GCATCCTTCATTACTC-1	Immature_BC
GCATCCTTCCATAATG-1	LC_ER-
GCATCCTTCGCTTCTA-1	LC_ER-
GCATCCTTCGTTAACA-1	LC_ER+
GCATCCTTCTTAAGTG-1	Immature_BC
GCATGAAAGAGAAGGG-1	LC_ER+
GCATGAAAGCCGCTAA-1	LC_ER+
GCATGAAAGCTGAGGG-1	LC_ER+
GCATGAAAGCTGGACC-1	LC_ER+
GCATGAAAGCTTATGA-1	LC_ER+
GCATGAAAGGAGGGTT-1	Immature_BC
GCATGAAAGGGACCTC-1	LC_ER-
GCATGAGCAACTCGCG-1	LC_ER-
GCATGAGCAATAATGG-1	LC_ER-
GCATGAGCAGGGAGGA-1	LC_ER+
GCATTAGGTAGCTGCG-1	HY_ER+_ER-
GCATTAGGTAGGTTTG-1	LC_ER+
GCATTAGGTCATCAAG-1	LC_ER+
GCATTAGGTTAGGTGC-1	LC_ER+
GCATTGCCACACAATT-1	Immature_BC
GCATTGCCAGCTTACA-1	LC_ER+
GCCAACATCATGAAGG-1	LC_ER-
GCCAACATCTGTAAGC-1	HY_ER+_ER-
GCCAATAGTGAGGTGA-1	LC_ER+
GCCAATAGTTGTTGTC-1	LC_ER+
GCCAATTAGACTCGCA-1	Immature_BC
GCCAATTAGCAACATC-1	HY_BC_ER+
GCCAATTAGGTGTCCA-1	LC_ER+
GCCACAATCAGTGAAG-1	LC_ER+
GCCACAATCCCGTTGT-1	LC_ER+
GCCACAATCCCGTTTA-1	LC_ER+
GCCACAATCGGGACCT-1	LC_ER-
GCCACACAGGCGGATG-1	LC_ER-
GCCACACAGTCACCAG-1	LC_ER-
GCCACACAGTGAGCGG-1	LC_ER-
GCCACACAGTTATGGC-1	LC_ER+
GCCACTAAGACCATAC-1	LC_ER+
GCCACTAAGACTATTG-1	Immature_BC
GCCACTAAGCAAGACA-1	Immature_BC
GCCACTAAGCTGGAAA-1	LC_ER+
GCCACTAAGTAAACCC-1	LC_ER+
GCCACTAAGTCTCACC-1	LC_ER+
GCCACTAAGTTCCTGC-1	LC_ER+
GCCAGGAAGGCGCTAC-1	Immature_BC
GCCAGGAAGGCTTAAC-1	LC_ER-
GCCAGGAAGTTTAACG-1	Immature_BC
GCCAGGTTCATGCTCC-1	LC_ER+
GCCAGGTTCATGGCTG-1	Immature_BC
GCCAGGTTCTTGCTAT-1	LC_ER-
GCCATGATCATTTGCT-1	Immature_BC
GCCATGATCTCACTAT-1	LC_ER-
GCCATGATCTCCTCTT-1	LC_ER-
GCCATTACAGATAGAC-1	HY_ER+_ER-
GCCATTACAGCCAGTT-1	LC_ER+
GCCATTACAGTAATAG-1	LC_ER+
GCCATTACATAGCGGA-1	LC_ER-
GCCCAAATCCCTGATC-1	HY_BC_ER+
GCCCAAATCGCTCACT-1	LC_ER+
GCCCATAAGCTTTGGG-1	LC_ER+
GCCCATAAGGGTTATC-1	LC_ER+
GCCCATAAGTAAGTCC-1	HY_ER+_ER-
GCCCATAAGTAGGATG-1	LC_ER-
GCCCGTTGTAGTTAAC-1	LC_ER-
GCCCGTTGTGTTGTGA-1	LC_ER+
GCCCGTTGTTAATGAC-1	LC_ER+
GCCCTCATCCAACTGG-1	Immature_BC
GCCCTCATCTGCAAGT-1	LC_ER-
GCCGTGAGTGTGTGGT-1	LC_ER-
GCCTACTTCGAGGAAC-1	LC_ER+
GCCTACTTCGATTTGA-1	LC_ER+
GCCTACTTCGTTACAA-1	LC_ER-
GCCTACTTCTGTTGCC-1	LC_ER-
GCCTATTGTACCAGGT-1	LC_ER+
GCCTATTGTCCTAACT-1	LC_ER+
GCCTATTGTCCTTCTC-1	LC_ER-
GCCTATTGTTACGCAA-1	Immature_BC
GCCTATTGTTTGGTTC-1	Immature_BC
GCCTCAAAGCACTTGG-1	LC_ER+
GCCTCAAAGCATTTCT-1	LC_ER+
GCCTCGACACATAGCC-1	LC_ER+
GCCTCGACACGAATCC-1	LC_ER+
GCCTCGACAGCAATAA-1	HY_ER+_ER-
GCCTCGACAGCTAATT-1	Immature_BC
GCCTGACAGACAAAGT-1	Immature_BC
GCCTGAGGTAACTACG-1	LC_ER-
GCCTGAGGTAATGGAA-1	LC_ER+
GCCTGAGGTGCAATGC-1	Immature_BC
GCCTGCTGTAATGACT-1	LC_ER-
GCCTGCTGTATACTGG-1	LC_ER-
GCCTGCTGTTAATGAC-1	Immature_BC
GCCTGCTGTTGCGCGA-1	LC_ER-
GCCTGCTGTTGGATAT-1	LC_ER+
GCCTGTGCAAGCGAGC-1	LC_ER+
GCCTGTGCAAGGTATA-1	LC_ER-
GCCTGTGCAAGTAAGC-1	LC_ER-
GCCTGTGCACTAGGTC-1	LC_ER+
GCCTGTGCAGGATAAC-1	LC_ER+
GCCTTAACACAGGGAC-1	LC_ER+
GCCTTAACATAAACCT-1	LC_ER+
GCCTTACTCAAGTGTC-1	Immature_BC
GCCTTACTCCACCTTA-1	LC_ER-
GCCTTACTCGCGCTAA-1	HY_BC_ER+
GCCTTACTCGGTCATG-1	LC_ER+
GCCTTACTCGGTTTGG-1	Immature_BC
GCCTTAGAGCGCTCAA-1	LC_ER+
GCCTTAGAGGCGCTTA-1	LC_ER-
GCCTTAGAGGTTTGAC-1	Immature_BC
GCCTTAGAGTTGCGTG-1	HY_ER+_ER-
GCCTTGCGTAAGGTTT-1	LC_ER+
GCCTTGCGTCAAACTG-1	LC_ER-
GCCTTGCGTCACAGCG-1	HY_ER+_ER-
GCCTTTATCACTAAGC-1	Immature_BC
GCCTTTATCCAGGTCA-1	LC_ER-
GCCTTTATCCCTCACG-1	LC_ER+
GCCTTTATCCTAGTTT-1	LC_ER+
GCCTTTATCCTGGCTT-1	LC_ER+
GCCTTTATCGGTTACG-1	LC_ER-
GCCTTTATCTGCAAGT-1	LC_ER-
GCCTTTGGTACGCGCA-1	Immature_BC
GCCTTTGGTAGCCATA-1	LC_ER+
GCCTTTGGTAGGTGTC-1	LC_ER+
GCGAAGCCACGAATCC-1	LC_ER+
GCGAAGCCACTAGGTC-1	LC_ER+
GCGAAGCCATTAGGTT-1	LC_ER+
GCGAAGTAGCTATGAC-1	LC_ER-
GCGAAGTAGGTCCGTA-1	LC_ER+
GCGAAGTAGTAAAGGT-1	HY_ER+_ER-
GCGAGTGAGATAACCC-1	LC_ER+
GCGAGTGAGGGTCTAT-1	LC_ER+
GCGAGTGAGGTATTGC-1	LC_ER-
GCGAGTGAGTTTGCGG-1	LC_ER+
GCGATATTCCTGCGAA-1	LC_ER-
GCGATATTCGGCTAGC-1	LC_ER+
GCGATATTCGTGCTTC-1	LC_ER+
GCGATATTCGTTATAG-1	LC_ER-
GCGATTAGTGTTTCAC-1	LC_ER+
GCGATTTAGCAGGTGG-1	LC_ER+
GCGATTTAGCGATACT-1	LC_ER+
GCGATTTAGCTCCTTA-1	LC_ER-
GCGATTTAGTGGCGGA-1	Immature_BC
GCGCAAACAACCTAAT-1	LC_ER-
GCGCAAACAATAAGCA-1	LC_ER+
GCGCAAACAATTGAAG-1	Immature_BC
GCGCAAACAGTAGGTG-1	Immature_BC
GCGCAAACATAAAGCA-1	LC_ER+
GCGCAATGTAAGCTTG-1	LC_ER-
GCGCAATGTCTAACAG-1	LC_ER-
GCGCAATGTGATGATT-1	HY_ER+_ER-
GCGCAATGTGTTTGTC-1	LC_ER-
GCGCCTTGTATTACCC-1	LC_ER+
GCGCCTTGTCACCAAA-1	Immature_BC
GCGCCTTGTGCTCCGT-1	LC_ER+
GCGCGATTCAAGCTAC-1	LC_ER+
GCGCGATTCCTAGTTT-1	LC_ER+
GCGCGATTCTCACACC-1	LC_ER-
GCGCGATTCTTGGATA-1	LC_ER+
GCGCTAGGTGCTCCGT-1	LC_ER+
GCGCTAGGTTGACTTC-1	Immature_BC
GCGCTAGGTTGCCTCA-1	LC_ER+
GCGCTTAAGAAGCTAG-1	LC_ER+
GCGCTTAAGACAACAG-1	HY_BC_ER+
GCGCTTAAGCCATCAG-1	Immature_BC
GCGCTTAAGCGGATAA-1	Immature_BC
GCGCTTAAGCTGTAAC-1	LC_ER+
GCGCTTAAGCTTCCCG-1	LC_ER+
GCGCTTAAGTAAGGGC-1	LC_ER+
GCGCTTGCAATTGCGC-1	LC_ER-
GCGCTTGCACTCAACA-1	LC_ER+
GCGCTTGCAGTTATCG-1	LC_ER+
GCGCTTGCATCCCTCA-1	LC_ER+
GCGGAACCAACTAGGG-1	Immature_BC
GCGGAACCAATTGAGA-1	LC_ER+
GCGGAACCAGCTTAGC-1	LC_ER-
GCGGAACCAGGCCTTG-1	LC_ER-
GCGGAACCATTAGCGC-1	LC_ER-
GCGGATACAGCAATAA-1	LC_ER+
GCGGATACAGCTTACA-1	LC_ER+
GCGGATACAGTAGGAT-1	LC_ER+
GCGGATACAGTTAAAG-1	LC_ER+
GCGGATACATCACTTC-1	LC_ER-
GCGGATACATTGTGTG-1	LC_ER+
GCGGGTTTCACCTGTC-1	LC_ER+
GCGGGTTTCATGACCG-1	LC_ER+
GCGGGTTTCGCTAAAC-1	LC_ER-
GCGGGTTTCTAACCTT-1	LC_ER-
GCGGTTATCCTAATAG-1	LC_ER-
GCGGTTATCGTTAGTA-1	LC_ER-
GCGGTTGGTAGCTGCG-1	LC_ER-
GCGGTTGGTGTGTGGT-1	LC_ER+
GCGGTTGGTTAAGGTT-1	LC_ER-
GCGGTTGGTTAGTACG-1	LC_ER-
GCGGTTGGTTGAGGTC-1	LC_ER-
GCGGTTGGTTGTTCAC-1	LC_ER-
GCGTGCTAGAGGGACT-1	LC_ER-
GCGTGCTAGGAGTCTT-1	LC_ER-
GCGTGCTAGGCTGTCA-1	HY_ER+_ER-
GCGTGCTAGTAGCTTA-1	Immature_BC
GCGTGCTAGTCTTGAA-1	LC_ER+
GCGTGCTAGTTAGTGC-1	LC_ER-
GCGTTTCTCACGCGGT-1	LC_ER+
GCGTTTCTCATTAGTG-1	LC_ER+
GCGTTTCTCCAGGTTG-1	Immature_BC
GCGTTTCTCCTGGCTT-1	LC_ER+
GCGTTTCTCTCACACC-1	LC_ER-
GCTAACAGTACCGAAC-1	LC_ER-
GCTAACAGTTAGTTGG-1	Immature_BC
GCTAACAGTTATTGCC-1	LC_ER-
GCTAACCCATGATTGT-1	Immature_BC
GCTAAGAAGCGGTTAT-1	LC_ER-
GCTAAGAAGCTACTGG-1	LC_ER+
GCTAAGAAGGACCTTG-1	LC_ER-
GCTAAGCGTGAAGCCT-1	LC_ER+
GCTAAGCGTTAGCCAA-1	HY_ER+_ER-
GCTAAGCGTTGCATCT-1	LC_ER+
GCTAAGTTCATGAAGG-1	LC_ER+
GCTAAGTTCCTCCCTC-1	LC_ER+
GCTAAGTTCCTTCAAT-1	Immature_BC
GCTAAGTTCGAGCTAT-1	Immature_BC
GCTAAGTTCGATTCTT-1	LC_ER+
GCTAAGTTCGCGCTAA-1	Immature_BC
GCTAAGTTCTGCAAAC-1	LC_ER+
GCTAAGTTCTTTGAGA-1	HY_ER+_ER-
GCTAATATCATTTGCT-1	Immature_BC
GCTAATATCTGTGAGT-1	Immature_BC
GCTAGCCAGCTCCTAC-1	LC_ER+
GCTAGCCAGGCTGTCA-1	LC_ER-
GCTAGCCAGTCACTAA-1	LC_ER-
GCTAGCCAGTTTCCGC-1	LC_ER-
GCTAGCGGTTGCGGAT-1	LC_ER+
GCTAGCGGTTGGCCGA-1	LC_ER-
GCTAGCTCAGAAACGT-1	Immature_BC
GCTAGCTCAGGCAAGC-1	LC_ER-
GCTAGTGTCACTTCAT-1	Immature_BC
GCTAGTGTCAGCCAAT-1	LC_ER+
GCTAGTGTCCCTCACG-1	Immature_BC
GCTAGTGTCCCTTGCG-1	LC_ER+
GCTAGTGTCGCCTGTT-1	LC_ER-
GCTAGTGTCGTAATCA-1	LC_ER+
GCTAGTGTCTAAGGTC-1	LC_ER-
GCTATAGGTTAACGAT-1	LC_ER+
GCTATAGGTTACCGGG-1	LC_ER+
GCTATCCTCAGCCAAT-1	LC_ER-
GCTATCCTCATAATCG-1	Immature_BC
GCTATCCTCTCGACCT-1	LC_ER-
GCTATTGCAATCATGT-1	LC_ER+
GCTATTGCAGCTCAAC-1	LC_ER-
GCTATTGCATAAGTTC-1	Immature_BC
GCTCAACCAAGGCCAA-1	Immature_BC
GCTCAACCAATTGCGC-1	Immature_BC
GCTCAACCACATTGCA-1	LC_ER+
GCTCAACCAGGATTAA-1	LC_ER+
GCTCAACCATGCTATG-1	LC_ER-
GCTCACAAGCTTAGTA-1	Immature_BC
GCTCACAAGGGTCTAT-1	LC_ER-
GCTCACAAGTAAGGGC-1	LC_ER-
GCTCATTGTACGTTTC-1	LC_ER-
GCTCATTGTCCTTCTC-1	LC_ER-
GCTCATTGTTTACCGT-1	LC_ER+
GCTCCTTAGCACAGCC-1	Immature_BC
GCTCCTTAGCCTCTCG-1	LC_ER+
GCTCGATCACTAGGTC-1	LC_ER-
GCTCTGGCATAATGTC-1	LC_ER-
GCTCTGTTCATGGCCA-1	Immature_BC
GCTCTGTTCCTTAGGG-1	LC_ER-
GCTGACATCAACCAAC-1	LC_ER-
GCTGACATCAAGTGTC-1	LC_ER-
GCTGACATCAATGTCA-1	LC_ER+
GCTGACATCAGGCTAT-1	LC_ER-
GCTGACATCGCATCCT-1	LC_ER-
GCTGACATCTCAATGA-1	LC_ER-
GCTGACATCTTAGTGA-1	LC_ER+
GCTGACCAGGTGCTGC-1	LC_ER+
GCTGAGGAGCAGGTTT-1	LC_ER-
GCTGAGGAGGTAAGGC-1	LC_ER-
GCTGAGGAGTAAGGGC-1	LC_ER-
GCTGAGGAGTCTTGAA-1	LC_ER-
GCTGATCCAGCTTAGC-1	LC_ER+
GCTGATCCATAATCCG-1	LC_ER+
GCTGCAATCGTTTCGC-1	LC_ER-
GCTGCACAGATAACCC-1	HY_ER+_ER-
GCTGCACAGCGGATAA-1	LC_ER+
GCTGCATCAAGTCGCT-1	LC_ER+
GCTGCATCACAGCCTG-1	LC_ER+
GCTGCATCAGCAAGTG-1	LC_ER-
GCTGCATCAGCATGTC-1	LC_ER+
GCTGCATCATAAAGCA-1	HY_BC_ER+
GCTGGATGTGCATTAG-1	LC_ER+
GCTGGATGTTATGTGG-1	LC_ER-
GCTGGTTCACCTACGG-1	LC_ER-
GCTGGTTCACTGACCG-1	Immature_BC
GCTGGTTCAGTCTATG-1	LC_ER+
GCTGGTTCAGTTATGT-1	LC_ER-
GCTGGTTCATCCCGCT-1	LC_ER-
GCTGGTTCATTGTCCT-1	LC_ER+
GCTGTAAGTGTTCCCA-1	LC_ER+
GCTGTACCAGGCTTCG-1	LC_ER+
GCTGTACCATGGCCCA-1	LC_ER+
GCTGTGATCCCTTGCG-1	LC_ER+
GCTGTGATCTATTGTC-1	Immature_BC
GCTGTGCAGCACCACA-1	LC_ER-
GCTTAAATCAATGTGC-1	LC_ER+
GCTTAACAGGGCTTAT-1	LC_ER+
GCTTACCTCAATCATG-1	Immature_BC
GCTTACCTCAATGACC-1	LC_ER+
GCTTACCTCAGGAAGC-1	LC_ER+
GCTTACCTCATGGTGT-1	LC_ER-
GCTTACCTCATTACTC-1	LC_ER+
GCTTACCTCGTTACAA-1	Prolif
GCTTACCTCTTAGTCT-1	Immature_BC
GCTTAGTAGTAACCAC-1	LC_ER+
GCTTAGTAGTAAGGGC-1	HY_ER+_ER-
GCTTAGTAGTTATCCT-1	LC_ER+
GCTTATCGTATTGTCC-1	LC_ER-
GCTTATCGTCAGGCAT-1	LC_ER+
GCTTATCGTGGATGTC-1	LC_ER-
GCTTCGCGTAATCCCT-1	Immature_BC
GCTTGACCAAGGGTTG-1	LC_ER-
GCTTGACCAGCTTAGC-1	LC_ER-
GCTTGTTGTACCGAAC-1	LC_ER+
GCTTTACGTCATCAAG-1	LC_ER-
GCTTTATTCAGCTAAC-1	LC_ER+
GCTTTATTCATTGCGG-1	Immature_BC
GCTTTATTCCCGTTGT-1	LC_ER-
GCTTTATTCCTTCTAG-1	LC_ER-
GCTTTCATCACGAATC-1	LC_ER+
GCTTTCATCCTAGTTT-1	LC_ER+
GCTTTCATCCTGTTCA-1	LC_ER+
GCTTTCATCGCTAGCA-1	LC_ER+
GCTTTCATCTAAATCG-1	LC_ER-
GCTTTGTGTAATGGCC-1	LC_ER-
GCTTTGTGTGCAATGC-1	LC_ER+
GCTTTGTGTGTTGCAA-1	LC_ER+
GGAAACTCACTTCACT-1	LC_ER+
GGAAACTCAGGTTACC-1	Immature_BC
GGAAACTCAGTTATGT-1	LC_ER+
GGAACAATCCCGAACA-1	LC_ER+
GGAACAATCGAGGAAC-1	LC_ER+
GGAACAATCGCTAAAC-1	Immature_BC
GGAACCACAGGTTACC-1	Immature_BC
GGAACCACATAAGGAC-1	LC_ER+
GGAACCACATAGACCC-1	Immature_BC
GGAACCTGTAACGGGA-1	Immature_BC
GGAACCTGTAATGGCC-1	LC_ER+
GGAACCTGTAGCTGGT-1	LC_ER+
GGAACCTGTCACAAAT-1	LC_ER-
GGAACCTGTCCAAATG-1	LC_ER+
GGAACCTGTTTGGCTT-1	HY_ER+_ER-
GGAACGGTCAATGTGC-1	LC_ER-
GGAACGGTCCACCTGT-1	LC_ER-
GGAACGGTCGCTATGG-1	LC_ER+
GGAACGGTCTATGACA-1	LC_ER+
GGAACTAAGAATCTCA-1	Immature_BC
GGAACTAAGTATCGCG-1	LC_ER-
GGAACTAAGTGCACGC-1	LC_ER-
GGAAGCTAGAACCTAC-1	LC_ER+
GGAAGCTAGAGCAAGC-1	LC_ER-
GGAAGCTAGGCGGGTA-1	LC_ER+
GGAAGCTAGGGTTATC-1	LC_ER-
GGAAGCTAGGTCCGTA-1	LC_ER+
GGAAGTATCGGCCAGT-1	LC_ER+
GGAAGTATCTCCTCTT-1	LC_ER-
GGAAGTATCTGCAAGT-1	LC_ER+
GGAATCTTCACCAATA-1	LC_ER+
GGAATCTTCAGAAACG-1	LC_ER-
GGAATCTTCATCCTCA-1	Immature_BC
GGAATCTTCATGGTTA-1	LC_ER+
GGAATCTTCGGGATTT-1	LC_ER-
GGAATCTTCGTTTCTG-1	Immature_BC
GGAATCTTCTGTAAGC-1	LC_ER-
GGACAGCCAAAGGCCA-1	Immature_BC
GGACAGCCACATAGCC-1	HY_ER+_ER-
GGACAGCCACCGGTAT-1	Immature_BC
GGACAGCCACGAACAG-1	LC_ER-
GGACAGCCAGCTAACC-1	HY_ER+_ER-
GGACAGCCAGGCCAAA-1	HY_ER+_ER-
GGACAGCCATTAAAGG-1	LC_ER-
GGACATAAGACTAAGG-1	LC_ER+
GGACATAAGCTTAACA-1	Immature_BC
GGACATAAGGTCCTAG-1	LC_ER+
GGACATAAGTGAACCT-1	LC_ER-
GGACCGAAGAAGGTGC-1	LC_ER-
GGACCTCAGCACGTTG-1	LC_ER+
GGACGAAGTAAGCTTG-1	LC_ER+
GGACGAAGTGCATTTC-1	LC_ER-
GGACGAAGTTCATCTA-1	LC_ER-
GGACGAAGTTGTTGTC-1	LC_ER-
GGACGGATCACTTCAT-1	LC_ER+
GGACGGATCATCACTT-1	LC_ER-
GGACGGATCTTACTCG-1	Immature_BC
GGACTAAAGCCAGGTC-1	LC_ER-
GGACTAAAGCGAGTAA-1	LC_ER+
GGACTAAAGGCTTAGT-1	Immature_BC
GGACTAAAGTAAACCC-1	LC_ER-
GGACTAAAGTCATCCC-1	LC_ER+
GGACTAAAGTTGGGCC-1	Immature_BC
GGAGCATAGGAAGCAC-1	HY_ER+_ER-
GGAGCATAGGGTCCAC-1	Immature_BC
GGAGCATAGTATTGGC-1	LC_ER+
GGAGCATAGTTCCTGC-1	HY_BC_ER+
GGAGCGATCAGGATGA-1	LC_ER+
GGAGCGATCATTGCAA-1	LC_ER+
GGAGCGATCCCGCATT-1	LC_ER+
GGAGCGATCCCGCCTA-1	LC_ER+
GGAGCGATCCGCCAAA-1	LC_ER-
GGAGTCTGTCTTTGAC-1	Immature_BC
GGAGTCTGTTACGCGG-1	Immature_BC
GGATAACCAAGGAATC-1	LC_ER+
GGATAACCATCCTAGA-1	LC_ER-
GGATACTTCGTAATCA-1	LC_ER-
GGATATTGTGTGAGAG-1	LC_ER-
GGATATTGTTAGAGGG-1	LC_ER+
GGATGAATCAATACGC-1	LC_ER+
GGATGAATCATGCATA-1	LC_ER+
GGATGAATCATTCATC-1	LC_ER+
GGATGAATCCTTGAGG-1	LC_ER+
GGATGAATCGCTTGCT-1	Immature_BC
GGATGAATCGGTACGC-1	LC_ER+
GGATGAATCGTTACTT-1	LC_ER-
GGATGTAAGGTCATTA-1	LC_ER-
GGATGTAAGTCACCTC-1	HY_ER+_ER-
GGATGTAAGTGAACAG-1	LC_ER+
GGATTATGTATTCGTC-1	LC_ER-
GGATTATGTTCCGGGA-1	LC_ER-
GGATTCAGTAAGCTCA-1	LC_ER+
GGATTCAGTAGGTTGC-1	LC_ER-
GGATTGCGTCCGGTTC-1	LC_ER-
GGATTGCGTTTCCGGC-1	Immature_BC
GGATTTATCAATTGGC-1	LC_ER+
GGATTTATCATTGCAA-1	LC_ER-
GGATTTATCCCGAAGC-1	LC_ER+
GGATTTATCCCTGGTT-1	LC_ER-
GGATTTATCGCACAAT-1	LC_ER+
GGATTTATCTATCGCC-1	LC_ER+
GGCAAATCAACTAGGG-1	LC_ER+
GGCAAATCAAGGTACG-1	LC_ER+
GGCAAATCAGAGAGCC-1	LC_ER-
GGCAAATCAGCTTAGC-1	LC_ER-
GGCAAGCCATGTTTGG-1	LC_ER-
GGCAAGCCATTGTGAT-1	Immature_BC
GGCAATCGTCGCGCAA-1	LC_ER-
GGCAATCGTTAACGAT-1	LC_ER+
GGCAATCGTTCACCAT-1	LC_ER-
GGCAATCGTTGCGCGA-1	Immature_BC
GGCAATCGTTGGGTTA-1	LC_ER-
GGCAGGATCATGCCTC-1	LC_ER+
GGCATGGAGAAACTGG-1	LC_ER-
GGCATGGAGAGCCGCT-1	LC_ER-
GGCATGGAGCACCACA-1	LC_ER-
GGCATGGAGCCTAATA-1	LC_ER-
GGCATGGAGCCTGTTC-1	LC_ER-
GGCATGGAGGTTTGCG-1	LC_ER+
GGCATTAGTGCACGCA-1	LC_ER-
GGCATTAGTGCATTAG-1	LC_ER-
GGCATTAGTTCCGCAC-1	LC_ER+
GGCATTAGTTGTCCAT-1	LC_ER+
GGCATTGTCACAGGAA-1	LC_ER+
GGCATTGTCACATTGA-1	Immature_BC
GGCATTGTCACTAGGT-1	LC_ER-
GGCATTGTCATGGTGT-1	LC_ER-
GGCATTGTCATTATGG-1	HY_ER+_ER-
GGCATTGTCCAAGTGT-1	Immature_BC
GGCATTGTCCGCCTAT-1	LC_ER-
GGCATTGTCCTGGTCT-1	LC_ER-
GGCATTGTCCTTAGTT-1	LC_ER+
GGCATTGTCGTGCTTC-1	LC_ER+
GGCATTGTCTATCGCC-1	LC_ER-
GGCATTGTCTTTGAGA-1	LC_ER-
GGCCAACTCAATAGCC-1	HY_ER+_ER-
GGCCAACTCCTCAGTC-1	LC_ER+
GGCCAACTCGATATTG-1	HY_ER+_ER-
GGCCATCAGCTGCACA-1	LC_ER+
GGCCATCAGGCACAGG-1	LC_ER+
GGCCATCAGGCTGGCT-1	LC_ER+
GGCCATCAGTGAGGGT-1	LC_ER-
GGCCGTTAGGACGTAA-1	LC_ER-
GGCCGTTAGGTGTTAC-1	LC_ER+
GGCCTAATCATGCCTC-1	LC_ER-
GGCCTAATCTTAGCGG-1	LC_ER+
GGCCTAATCTTTAAGG-1	LC_ER-
GGCCTCTGTGTTTGAG-1	LC_ER+
GGCCTCTGTTAGAGGG-1	LC_ER-
GGCCTTAAGGTAAGGC-1	LC_ER-
GGCCTTAAGGTTTACA-1	LC_ER+
GGCCTTAAGTAGCGCC-1	LC_ER+
GGCCTTAAGTCACTCC-1	LC_ER+
GGCCTTCGTCACAGCG-1	Immature_BC
GGCCTTCGTGATGAAA-1	LC_ER+
GGCGATACAAATATCC-1	HY_BC_ER+
GGCGATACAGAGGCTA-1	LC_ER+
GGCGATACAGTCTAGC-1	LC_ER+
GGCGATACATAAGCAA-1	LC_ER-
GGCGATACATGCTTAG-1	LC_ER-
GGCGCTAGTCAAAGAA-1	LC_ER-
GGCGCTAGTCAATAGT-1	LC_ER-
GGCGCTAGTGCATCGG-1	LC_ER+
GGCGCTAGTGTCCAAA-1	LC_ER+
GGCGCTAGTTAACACG-1	Immature_BC
GGCGCTAGTTGCGGAT-1	LC_ER+
GGCGGTAAGACACCGC-1	LC_ER+
GGCGGTAAGCTGCACA-1	LC_ER-
GGCGGTAAGGAACACA-1	HY_BC_ER+
GGCGGTAAGTAGCCAT-1	LC_ER+
GGCGGTAAGTCACTAA-1	LC_ER+
GGCGGTAAGTCATTTC-1	LC_ER+
GGCGGTAAGTTATTCC-1	LC_ER-
GGCGGTTTCAGCAAGA-1	LC_ER-
GGCGGTTTCAGGAAGC-1	LC_ER-
GGCGGTTTCATTATGG-1	LC_ER-
GGCGGTTTCCGGTTGA-1	LC_ER+
GGCGGTTTCGAGGAAC-1	LC_ER-
GGCGGTTTCTCACTCA-1	HY_ER+_ER-
GGCGTTATCGCTAGAT-1	LC_ER-
GGCGTTATCTTGTTCG-1	LC_ER-
GGCTAGACAAACGGGC-1	Immature_BC
GGCTAGACAATGAATG-1	LC_ER+
GGCTAGACAATGCCCG-1	LC_ER+
GGCTAGACACAGGATG-1	LC_ER+
GGCTAGTGTAACGTGC-1	LC_ER-
GGCTAGTGTCCACAAA-1	LC_ER-
GGCTAGTGTCGACTAA-1	LC_ER+
GGCTAGTGTTCACCCA-1	LC_ER-
GGCTATGTCACTTCAT-1	LC_ER+
GGCTATGTCATTGTTC-1	LC_ER-
GGCTATGTCCTCAGCT-1	LC_ER+
GGCTATGTCTAAATCG-1	LC_ER-
GGCTATGTCTTGGATA-1	LC_ER+
GGCTATGTCTTGTTCG-1	LC_ER-
GGCTATTAGGAGTAAT-1	LC_ER-
GGCTATTAGGCCATCA-1	HY_ER+_ER-
GGCTATTAGGTGAAGC-1	LC_ER-
GGCTCAATCATGGCCA-1	LC_ER-
GGCTCAATCCAACTGG-1	HY_ER+_ER-
GGCTCAATCCACCCTG-1	LC_ER+
GGCTCAATCCCGTTTA-1	LC_ER-
GGCTCAATCCCTCATA-1	LC_ER-
GGCTCAATCGTTAAGC-1	LC_ER+
GGCTCAATCTCCATGC-1	LC_ER+
GGCTCACAGCGAAGTA-1	LC_ER+
GGCTCACAGGGACGCA-1	LC_ER+
GGCTCACAGGGCTTAT-1	LC_ER-
GGCTCACAGGTAAGGC-1	LC_ER+
GGCTCACAGTACTGGT-1	LC_ER+
GGCTGAGAGAAGCTAG-1	LC_ER+
GGCTGAGAGCATGTTA-1	LC_ER+
GGCTGAGAGGGCTTTG-1	LC_ER+
GGCTGAGAGTCACCTC-1	Immature_BC
GGCTGGTTCCTGTTCA-1	LC_ER+
GGCTGGTTCGTTTCTG-1	LC_ER-
GGCTGTCAGCACGATT-1	LC_ER-
GGCTGTCAGCCTAATA-1	LC_ER+
GGCTGTCAGCGATACT-1	HY_ER+_ER-
GGCTGTCAGGCACAGG-1	HY_ER+_ER-
GGCTGTCAGGCTAATC-1	LC_ER-
GGCTTAAGTACGGTAC-1	LC_ER+
GGCTTAAGTAGGTGTC-1	LC_ER+
GGCTTAAGTTTGGGTA-1	LC_ER+
GGCTTCAAGCGCCTAA-1	LC_ER+
GGCTTCAAGCTACTGG-1	LC_ER-
GGCTTCAAGTCTCACC-1	LC_ER-
GGGAATATCAGGAAGC-1	Immature_BC
GGGAATATCATGGCCA-1	LC_ER-
GGGAATATCATTGTTC-1	HY_ER+_ER-
GGGAATATCGACCTGA-1	HY_ER+_ER-
GGGAATATCTAATCTC-1	LC_ER+
GGGAATATCTTGCAAA-1	LC_ER-
GGGAATATCTTGTCCA-1	Immature_BC
GGGAGTAGTTTATGGG-1	LC_ER+
GGGATTAAGCTTAGCG-1	LC_ER+
GGGATTAAGTGCACGC-1	LC_ER+
GGGCAATAGCACAGCC-1	LC_ER-
GGGCAATAGCATGTCG-1	LC_ER+
GGGCAATAGGACAATG-1	LC_ER+
GGGCATGAGAGGCTAA-1	Immature_BC
GGGCATGAGGACCTTG-1	LC_ER-
GGGCATGAGGAGTCTT-1	LC_ER-
GGGCATGAGGCACAGG-1	LC_ER+
GGGCATGAGTCACTCC-1	Immature_BC
GGGCATTGTAAGCTCA-1	LC_ER-
GGGCATTGTAATGGCC-1	LC_ER-
GGGCATTGTAGGTTAT-1	LC_ER+
GGGCCTAGTAGCCTCC-1	LC_ER-
GGGCCTAGTATTGCAG-1	HY_BC_ER+
GGGCCTAGTCTCAGCC-1	HY_ER+_ER-
GGGCCTAGTTACAAAC-1	LC_ER+
GGGCGAATCAAAGGCA-1	HY_ER+_ER-
GGGCTAACAGCACGAA-1	HY_ER+_ER-
GGGCTAACAGGATAAC-1	Immature_BC
GGGCTAACATCAGCAC-1	Immature_BC
GGGTATTTCGATTCTT-1	Immature_BC
GGGTCAACAAATACCT-1	LC_ER-
GGGTCAACAAATTGCT-1	LC_ER-
GGGTCAACAATACTGT-1	LC_ER+
GGGTCAACATAGGCGA-1	LC_ER+
GGGTGAAGTTATGTGG-1	LC_ER+
GGGTGAAGTTCACTGT-1	LC_ER+
GGGTGTTGTAATAGCT-1	HY_ER+_ER-
GGGTGTTGTCCGTAGG-1	LC_ER+
GGGTGTTGTGATGAGG-1	LC_ER+
GGGTTACGTAGCTAAT-1	LC_ER-
GGGTTACGTTATGTGG-1	LC_ER-
GGGTTACGTTCCGCAC-1	LC_ER+
GGGTTATTCAAACCTA-1	HY_BC_ER+
GGGTTATTCACTCAAA-1	LC_ER+
GGGTTATTCAGCACGC-1	Immature_BC
GGGTTATTCATGTGGT-1	LC_ER-
GGGTTATTCCTTCGTA-1	LC_ER-
GGGTTATTCGGGACTC-1	Immature_BC
GGGTTTCCAAGGCCAA-1	LC_ER-
GGGTTTCCACAACAGG-1	LC_ER-
GGGTTTCCACAGAAAC-1	LC_ER-
GGGTTTCCACGTAATT-1	LC_ER-
GGGTTTCCACTGACTA-1	HY_ER+_ER-
GGGTTTGTCAATTGGC-1	LC_ER+
GGGTTTGTCACATTGA-1	LC_ER-
GGGTTTGTCAGGCTAT-1	Immature_BC
GGGTTTGTCCTTGAGG-1	Immature_BC
GGTAAACCAAGGACCA-1	LC_ER+
GGTAAACCAATTGAGA-1	LC_ER-
GGTAAACCAGGCTACT-1	Immature_BC
GGTAACCGTCATCAAG-1	LC_ER+
GGTAACTTCATAACGC-1	Immature_BC
GGTAACTTCATTACGA-1	Immature_BC
GGTAACTTCCGGAACC-1	LC_ER+
GGTAACTTCTACCTGC-1	Immature_BC
GGTAAGGGTCCTTTAA-1	LC_ER-
GGTAAGGGTCTTGCAT-1	LC_ER-
GGTAAGGGTGACCTGG-1	LC_ER+
GGTAAGGGTGGAAACG-1	LC_ER+
GGTAAGGGTTAGTACG-1	LC_ER+
GGTAATTGTTAATGAC-1	LC_ER+
GGTACAAAGCCTGGTA-1	LC_ER-
GGTACAAAGCTTATGA-1	LC_ER-
GGTACAAAGGAACGCG-1	LC_ER+
GGTACAAAGGGTTATC-1	LC_ER+
GGTACCGGTGTGCAAC-1	LC_ER+
GGTACTAGTGGTTATG-1	LC_ER+
GGTACTTAGAGCCGCT-1	LC_ER+
GGTACTTAGCTAGAAG-1	LC_ER-
GGTACTTAGTATGTGC-1	LC_ER-
GGTAGGAGTTTGAGGC-1	Immature_BC
GGTATGTTCCCGTTAC-1	LC_ER+
GGTATGTTCGCTAGCA-1	Immature_BC
GGTATGTTCGCTAGTG-1	LC_ER+
GGTATGTTCGCTCACT-1	LC_ER+
GGTATGTTCGGCCAGT-1	LC_ER+
GGTATGTTCGTAATCA-1	LC_ER+
GGTATTGGTGCTCACC-1	Immature_BC
GGTATTTCAACACCTA-1	LC_ER+
GGTATTTCAAGGAATC-1	Immature_BC
GGTATTTCACGTGCTG-1	LC_ER+
GGTATTTCAGGATTAA-1	HY_ER+_ER-
GGTATTTCATGTTGCA-1	LC_ER+
GGTATTTCATTAAAGG-1	LC_ER-
GGTCAAGCAAGGGTTG-1	LC_ER+
GGTCAAGCAAGGTAAC-1	Immature_BC
GGTCAAGCACAATGCC-1	LC_ER+
GGTCAAGCACAATGTT-1	LC_ER+
GGTCAAGCAGGAACAT-1	LC_ER+
GGTCAATTCACTAAGC-1	Immature_BC
GGTCAATTCATGCTAA-1	LC_ER+
GGTCAATTCCTGGTGA-1	LC_ER-
GGTCAATTCGGCCATA-1	LC_ER+
GGTCAGGAGCCACATG-1	LC_ER-
GGTCAGGAGCCGCTTT-1	LC_ER-
GGTCAGGAGGTAAGCA-1	LC_ER+
GGTCAGGAGTGAGCGG-1	LC_ER-
GGTCAGGAGTTTGGTA-1	LC_ER-
GGTCATTAGGTCCTAG-1	LC_ER+
GGTCATTAGTAACGGA-1	LC_ER-
GGTCATTAGTAAGAAC-1	LC_ER+
GGTCATTAGTCAGTAC-1	LC_ER-
GGTCCATCACAGGAAT-1	LC_ER+
GGTCCATCATGTTGTG-1	LC_ER-
GGTCCATCATTGTCAG-1	LC_ER+
GGTCCGTAGACTTATG-1	LC_ER-
GGTCCGTAGATGGACA-1	LC_ER-
GGTCCGTAGGTCGATT-1	LC_ER+
GGTCCGTAGGTGCTGC-1	LC_ER+
GGTCCGTAGTGGACAA-1	LC_ER+
GGTCCTGCAAAGCTAA-1	LC_ER-
GGTCCTGCAGAAATGC-1	LC_ER-
GGTCCTGCAGCCAGAA-1	Immature_BC
GGTCCTGCATGAGTTT-1	LC_ER-
GGTCGGTTCAATACGC-1	LC_ER-
GGTCGGTTCACTAATG-1	LC_ER+
GGTCGGTTCTCGACCT-1	LC_ER-
GGTCGGTTCTTTAAGG-1	LC_ER-
GGTCTTGAGCACAGGG-1	LC_ER-
GGTCTTGAGGCAATAG-1	LC_ER-
GGTCTTGAGGTTACGT-1	LC_ER+
GGTCTTGAGTAAGAAC-1	LC_ER-
GGTCTTGAGTAGGCGG-1	Immature_BC
GGTCTTTGTCAATACG-1	Immature_BC
GGTCTTTGTCATCATC-1	LC_ER-
GGTCTTTGTGAGGTGA-1	LC_ER+
GGTCTTTGTTGGTTGA-1	LC_ER+
GGTGAGCCACCATATG-1	LC_ER+
GGTGAGCCAGGGAGCT-1	HY_ER+_ER-
GGTGAGGTCCCGCAAA-1	LC_ER+
GGTGAGGTCGAGCTAT-1	LC_ER+
GGTGAGGTCGTTTCCA-1	LC_ER+
GGTGAGTAGGGTGGAT-1	Immature_BC
GGTGATTTCAGGAACA-1	LC_ER-
GGTGATTTCTAACTGA-1	LC_ER+
GGTGATTTCTACCTAT-1	LC_ER-
GGTGCTGGTTACCTGT-1	LC_ER+
GGTGCTGGTTCAAGAT-1	LC_ER-
GGTGCTGGTTTGACCT-1	HY_BC_ER+
GGTGCTTCAAACCTTG-1	LC_ER-
GGTGCTTCAGTTATCG-1	LC_ER-
GGTGCTTCATAGCGAG-1	LC_ER-
GGTGCTTCATTGCGTA-1	LC_ER+
GGTGTCCAGAGGAGGA-1	LC_ER-
GGTGTCCAGGAGCACG-1	LC_ER-
GGTGTCCAGGGCTAAA-1	HY_ER+_ER-
GGTGTCCAGTTAACCA-1	LC_ER-
GGTGTGACAAGCTTAT-1	LC_ER-
GGTGTGACAATCATGT-1	LC_ER+
GGTGTGACACTATGGC-1	LC_ER-
GGTGTGACACTGGCTG-1	LC_ER+
GGTGTGACATGGAGGC-1	HY_ER+_ER-
GGTGTGACATTAAGCT-1	LC_ER-
GGTGTTGTCCTGCGAA-1	LC_ER+
GGTGTTGTCGAGGAAC-1	HY_ER+_ER-
GGTGTTGTCGTTACTT-1	LC_ER+
GGTGTTGTCTGTTCAT-1	HY_ER+_ER-
GGTGTTGTCTTTAGGA-1	LC_ER-
GGTTAATGTATTACCC-1	LC_ER-
GGTTAATGTCAAACTG-1	LC_ER-
GGTTAATGTGTGTCCC-1	LC_ER+
GGTTACCCAAGCTACC-1	LC_ER+
GGTTACCCAATTTAGC-1	LC_ER-
GGTTACCCATGTTTGG-1	LC_ER+
GGTTACTAGCTCAATA-1	LC_ER-
GGTTAGCGTAGGTTAT-1	LC_ER-
GGTTAGCGTCCTTAGT-1	LC_ER-
GGTTAGCGTCTTTGAC-1	LC_ER-
GGTTAGCGTTGGTTGA-1	LC_ER+
GGTTATATCCTGAATA-1	LC_ER+
GGTTATGGTACGCGCA-1	LC_ER-
GGTTATGGTACGGTAC-1	HY_BC_ER+
GGTTATGGTGAGCAAG-1	LC_ER+
GGTTATGGTGCTGGTG-1	LC_ER+
GGTTATGGTTCCTGTG-1	LC_ER-
GGTTCCCGTAAACAAG-1	Immature_BC
GGTTCCCGTGCGCATG-1	LC_ER+
GGTTCCCGTTACTTCA-1	Immature_BC
GGTTCCCGTTATTGCC-1	LC_ER+
GGTTCCCGTTTGCTGT-1	LC_ER-
GGTTCTTGTGCCTCAC-1	LC_ER-
GGTTCTTGTTCACTGT-1	LC_ER+
GGTTCTTGTTGCACGG-1	LC_ER-
GGTTCTTGTTGCCTCA-1	LC_ER+
GGTTGACGTAACGGGA-1	LC_ER-
GGTTGACGTTACAAAC-1	LC_ER+
GGTTGACGTTATTGCC-1	LC_ER+
GGTTGAGCAACTGGCT-1	LC_ER-
GGTTGAGCACTTAACG-1	LC_ER-
GGTTGAGCATAACGGG-1	LC_ER+
GGTTGCATCATAACCA-1	LC_ER+
GGTTGCATCATTACTC-1	HY_ER+_ER-
GGTTGCATCCCTTGCG-1	LC_ER+
GGTTGCATCGGCCAGT-1	LC_ER+
GGTTGCGGTCCACAAA-1	LC_ER-
GGTTGCGGTTGGTTCT-1	LC_ER-
GGTTGCGGTTTCCGGC-1	Immature_BC
GGTTGCGGTTTGGTTC-1	LC_ER-
GGTTGCTCAAACATAG-1	LC_ER+
GGTTGCTCAATCCTGA-1	LC_ER-
GGTTGCTCACAATGTT-1	LC_ER-
GGTTGCTCAGTTAGCC-1	LC_ER-
GGTTGCTCATACTCCT-1	Immature_BC
GGTTGGTGTACAATGT-1	LC_ER-
GGTTGGTGTGTTGTAG-1	Immature_BC
GGTTTAATCAGGGCCT-1	LC_ER+
GGTTTAATCATTGCGG-1	LC_ER-
GGTTTAATCCCTCAAC-1	Immature_BC
GGTTTAATCCTCAGTC-1	LC_ER+
GGTTTAATCGGGACCT-1	LC_ER+
GGTTTCCTCAAGTGAG-1	HY_ER+_ER-
GGTTTCTGTAGCCTCC-1	LC_ER+
GGTTTCTGTAGTTGGC-1	LC_ER-
GGTTTCTGTCAAGTGC-1	Immature_BC
GGTTTCTGTGGACCTG-1	LC_ER+
GGTTTCTGTTTCCTCC-1	LC_ER+
GGTTTGTAGCGATAGA-1	LC_ER-
GGTTTGTAGCTATATG-1	LC_ER-
GTAAAGCCAAACCTAT-1	HY_BC_ER+
GTAAAGCCACCTACGG-1	LC_ER-
GTAAAGCCAGTTTCTC-1	LC_ER-
GTAAAGCCATTAGGTT-1	LC_ER+
GTAAGCAAGCATTTCT-1	LC_ER+
GTAAGCAAGGGATGCG-1	Immature_BC
GTAAGCGCAAACGGGC-1	LC_ER-
GTAAGCTTCAAATCGC-1	LC_ER-
GTAAGCTTCAATACGC-1	LC_ER+
GTAAGGTCAAGGTGGC-1	LC_ER+
GTAAGGTCAGGCATGA-1	LC_ER+
GTAAGGTCATAGCTGC-1	LC_ER-
GTAATAGCACATACTG-1	LC_ER-
GTAATAGCACCTGCCT-1	LC_ER+
GTAATAGCACTTACAG-1	LC_ER-
GTACAATGTACCGTAA-1	Immature_BC
GTACAATGTGGTTAGC-1	LC_ER+
GTACAATGTTAACACG-1	LC_ER-
GTACACCCAATTGAGA-1	LC_ER+
GTACACCCACCTAATG-1	LC_ER+
GTACACCCATAGCTTG-1	Immature_BC
GTACACCCATCGCTCC-1	LC_ER+
GTACCGGGTAAGCACC-1	LC_ER+
GTACCGGGTAGGTTTG-1	LC_ER+
GTACCGGGTGTTGTGA-1	LC_ER+
GTACCGGGTGTTTCAC-1	LC_ER-
GTACCGGGTGTTTGCT-1	LC_ER+
GTACCGGGTTGAAGCC-1	LC_ER+
GTACCTTGTAGTTGGC-1	LC_ER+
GTACCTTGTGGGTACT-1	LC_ER+
GTACGTAGTAGCTGCG-1	Immature_BC
GTACGTAGTAGTTGGC-1	LC_ER+
GTACGTAGTGTCCAAA-1	LC_ER-
GTACGTAGTGTGAGAG-1	HY_ER+_ER-
GTACGTAGTGTGAGGA-1	LC_ER-
GTACGTAGTGTGCAAC-1	LC_ER+
GTACTAATCAGTGAAG-1	LC_ER+
GTACTAATCCAAGTGT-1	LC_ER-
GTACTAATCGGTTTCC-1	LC_ER-
GTACTAATCTACTAAG-1	LC_ER-
GTACTAGGTCGTAATG-1	LC_ER+
GTACTGGTCGCAGGCT-1	Immature_BC
GTACTGGTCTTGACCC-1	Immature_BC
GTACTTAAGCCTGAGC-1	LC_ER+
GTACTTAAGGACCTTG-1	LC_ER+
GTACTTAAGGGCTTTG-1	LC_ER-
GTACTTCGTCCGGTTC-1	LC_ER-
GTACTTCGTGTCCAGG-1	LC_ER+
GTACTTCGTTAGCGTA-1	LC_ER+
GTAGCCATCGAGGAAC-1	Immature_BC
GTAGCCATCGGTCAAT-1	LC_ER+
GTAGCCATCTTGAGCG-1	LC_ER+
GTAGCGCTCAATCTCT-1	Immature_BC
GTAGCGCTCAATTGGC-1	LC_ER-
GTAGCGCTCCTAATGA-1	Immature_BC
GTAGCGCTCGGTCAAT-1	LC_ER-
GTAGCTGTCGTAACGT-1	LC_ER-
GTAGCTGTCTAAATCG-1	LC_ER+
GTAGGAGGTAAACAAG-1	LC_ER+
GTAGGAGGTATGTGGC-1	LC_ER+
GTAGGAGGTGTGCAAC-1	Immature_BC
GTAGGAGGTGTTTGAG-1	LC_ER-
GTAGGAGGTTAATGCG-1	LC_ER-
GTAGGAGGTTGACTTC-1	LC_ER+
GTAGGATCAAACCTTG-1	Immature_BC
GTAGGATCATGAAATG-1	LC_ER+
GTAGGCGAGTAGCGGG-1	LC_ER+
GTAGGCGAGTAGGCGG-1	LC_ER+
GTAGGTGCAATCATGT-1	Immature_BC
GTAGGTGCACAAAGCG-1	LC_ER-
GTAGGTGCAGGGAGCT-1	LC_ER+
GTAGGTGCATAATGAG-1	LC_ER-
GTAGGTGCATCGCTCC-1	Immature_BC
GTAGGTGCATGAATCT-1	LC_ER-
GTAGTTATCCTCGATC-1	LC_ER-
GTAGTTTCAAATGCCC-1	Immature_BC
GTAGTTTCAATTATGC-1	LC_ER-
GTAGTTTCAGCTACGT-1	HY_ER+_ER-
GTAGTTTCATGAAGTA-1	Immature_BC
GTATCGCCAAGGTAAC-1	LC_ER-
GTATCGCCAGAGGCTA-1	LC_ER-
GTATCGCCATCAGTAT-1	LC_ER-
GTATGTGGTCGTTACT-1	LC_ER-
GTATGTGGTTTAGCTC-1	LC_ER+
GTATGTGGTTTATGGG-1	LC_ER+
GTATGTTCAAACAACA-1	LC_ER-
GTATGTTCAAACTGTT-1	LC_ER-
GTATGTTCAAATTCGT-1	LC_ER-
GTATGTTCAGGAACTG-1	LC_ER+
GTATGTTCAGGCTAGA-1	LC_ER+
GTATGTTCATAAAGCA-1	LC_ER+
GTATTCAAGCCATCAG-1	LC_ER+
GTATTCAAGCTCAATA-1	LC_ER-
GTATTCAAGGACCTGC-1	LC_ER+
GTATTCAAGTAAGAAC-1	LC_ER+
GTATTGATCAGCAAAG-1	LC_ER+
GTATTGATCCCATAAA-1	LC_ER-
GTATTGATCTAGCGTG-1	LC_ER-
GTATTGCAGGACCGCT-1	LC_ER-
GTATTGCAGGAGGTTA-1	LC_ER+
GTATTGCAGTCTCACC-1	LC_ER+
GTATTGCAGTTACCGG-1	LC_ER-
GTATTGTCACATTGCA-1	LC_ER-
GTATTGTCAGGAACAT-1	LC_ER-
GTCAAACTCAAACCGT-1	LC_ER+
GTCAATATCAAGCGCC-1	HY_ER+_ER-
GTCAATATCCGTGACA-1	LC_ER+
GTCAGGCTCAGCACGC-1	Immature_BC
GTCATCACAAAGCGGC-1	LC_ER-
GTCATCACAATGAATG-1	LC_ER-
GTCATCACATTCCTCG-1	HY_ER+_ER-
GTCATCCTCGGTCAGC-1	Immature_BC
GTCATCCTCGTTAAGC-1	LC_ER+
GTCATCCTCTCATCAT-1	LC_ER-
GTCATCCTCTTTAAGG-1	LC_ER-
GTCATGAGTAAACAAG-1	LC_ER-
GTCATGAGTAATCGTG-1	LC_ER+
GTCATGAGTGGACATC-1	HY_ER+_ER-
GTCATGAGTGTTGTAG-1	LC_ER+
GTCATGCCAAATGCCC-1	LC_ER+
GTCATGCCACAAGCCT-1	Immature_BC
GTCATGCCAGATTCAT-1	LC_ER+
GTCATGCCAGGAAGCC-1	LC_ER+
GTCATGCCAGGCCAAA-1	LC_ER+
GTCATGCCAGTTTGGC-1	HY_ER+_ER-
GTCATGCCATAGACTT-1	LC_ER+
GTCATGCCATGTGGGA-1	LC_ER+
GTCATTAAGCAGGTTT-1	LC_ER+
GTCATTAAGTCATGCG-1	LC_ER+
GTCCAAGTCACGAATC-1	LC_ER+
GTCCAAGTCAGCACGC-1	LC_ER-
GTCCAAGTCGCAAACT-1	LC_ER-
GTCCAAGTCTCGACCT-1	LC_ER+
GTCCAGGGTGTTGCTT-1	HY_ER+_ER-
GTCCAGGGTTTAGCGA-1	LC_ER-
GTCCATTGTACGGTAC-1	LC_ER-
GTCCATTGTCTTTGAC-1	LC_ER+
GTCCGTAAGAGGAAGG-1	LC_ER+
GTCCGTAAGGACCAGG-1	LC_ER+
GTCCGTAAGGCGCTTA-1	LC_ER+
GTCCTAGAGCCACATG-1	LC_ER+
GTCCTAGAGGTGAGAC-1	LC_ER+
GTCCTCAGTGAGCAAG-1	LC_ER+
GTCCTCAGTGTTCCCA-1	Immature_BC
GTCCTCAGTTAGCTGA-1	LC_ER+
GTCCTCCCAAGGATTA-1	LC_ER+
GTCCTCCCAATCGCAC-1	LC_ER-
GTCCTCCCAATGCGCT-1	LC_ER+
GTCCTCCCAATTATGC-1	Prolif
GTCGAAGCAAACAACA-1	LC_ER-
GTCGAAGCAAACTGTT-1	LC_ER+
GTCGAAGCAGTAAAGC-1	Immature_BC
GTCGAAGCATCGTTCT-1	Immature_BC
GTCGAAGCATTAAACC-1	LC_ER-
GTCGAAGCATTCCTGT-1	Immature_BC
GTCGAGGAGAGGAGTC-1	LC_ER+
GTCGAGGAGGTTAGAG-1	LC_ER+
GTCGAGGAGTCATCCC-1	LC_ER-
GTCGCAATCCTCATGC-1	LC_ER-
GTCGGTTCAATAATGG-1	LC_ER-
GTCGGTTCACATACTG-1	LC_ER+
GTCGGTTCAGTTATGT-1	LC_ER+
GTCTAACAGTCATGCG-1	LC_ER+
GTCTAACAGTTATCTC-1	LC_ER+
GTCTAATCAAGCCACT-1	LC_ER+
GTCTAATCACAGAAAC-1	LC_ER+
GTCTAATCAGTTATGT-1	LC_ER+
GTCTAGCCACGGTACT-1	LC_ER-
GTCTATGCAGTTTACG-1	Immature_BC
GTCTATGCATCATGTG-1	LC_ER-
GTCTATGCATGAATCT-1	LC_ER+
GTCTCACTCATGGTGT-1	LC_ER+
GTCTCACTCCGCTAGA-1	LC_ER+
GTCTTGCTCCTTGTTG-1	LC_ER-
GTCTTTAGTAAAGCAA-1	Immature_BC
GTCTTTAGTAATAACC-1	LC_ER+
GTCTTTAGTGTAACCA-1	LC_ER+
GTCTTTAGTTAACGGC-1	HY_ER+_ER-
GTCTTTAGTTCGGTAA-1	LC_ER+
GTCTTTAGTTTGTCTA-1	LC_ER+
GTGAACAAGGCATGAA-1	LC_ER+
GTGAACAAGGCATTGT-1	LC_ER-
GTGAACAAGGTGTCCA-1	Immature_BC
GTGAATCTCATTAGCA-1	LC_ER-
GTGAATCTCGCCTGTT-1	LC_ER+
GTGAATCTCTCCTCTT-1	LC_ER+
GTGAGCGAGGAATAAC-1	LC_ER-
GTGAGCGAGGTCCTGA-1	LC_ER-
GTGAGGAGTAATCACG-1	LC_ER+
GTGAGGAGTAGTTGGC-1	LC_ER+
GTGATCAGTGCCTCAC-1	LC_ER+
GTGATCAGTTTGACCT-1	Immature_BC
GTGATGAAGGTAACGA-1	LC_ER-
GTGCAAGCAAACCTTG-1	LC_ER+
GTGCAAGCAGGCATGA-1	LC_ER-
GTGCAAGCAGGCTAAG-1	HY_ER+_ER-
GTGCAAGCAGTAAAGC-1	HY_ER+_ER-
GTGCAAGCATGTCAGC-1	HY_BC_ER+
GTGCACGGTACAATGT-1	LC_ER+
GTGCACGGTGGATTAT-1	Immature_BC
GTGCACGGTGTAACCA-1	Immature_BC
GTGCATTAGCAAACCT-1	LC_ER+
GTGCATTAGGCATGAA-1	LC_ER+
GTGCATTAGGCCATCA-1	LC_ER+
GTGCATTAGGCTAATC-1	LC_ER+
GTGCATTAGGTGTCCA-1	Immature_BC
GTGCATTAGTACTGGT-1	LC_ER+
GTGCATTAGTTATGGC-1	LC_ER+
GTGCATTAGTTTCCGC-1	LC_ER+
GTGCGCAGTATGGTGC-1	Immature_BC
GTGCGCAGTTAATGCG-1	LC_ER-
GTGCGCAGTTACGCGG-1	LC_ER-
GTGCGCAGTTCCGCAC-1	LC_ER+
GTGCGCAGTTTCGCGC-1	LC_ER+
GTGCTCAAGAGAGCCG-1	LC_ER-
GTGCTCAAGCATTATG-1	LC_ER+
GTGCTCAAGCCTGACA-1	LC_ER+
GTGCTCAAGCCTGAGC-1	LC_ER+
GTGCTCAAGGACACTT-1	LC_ER+
GTGCTCAAGGACTTAC-1	LC_ER+
GTGCTCAAGGAGTCGG-1	LC_ER-
GTGCTCAAGGATTTGC-1	LC_ER+
GTGCTCAAGGGTCCAC-1	Immature_BC
GTGCTCAAGTTTGTCT-1	LC_ER+
GTGCTCCGTAAAGCAA-1	Immature_BC
GTGCTCCGTAATCCCT-1	LC_ER-
GTGCTCCGTACCAGGT-1	LC_ER+
GTGCTCCGTCAAAGAA-1	HY_ER+_ER-
GTGCTCCGTCAGGAAG-1	LC_ER+
GTGCTCCGTTAGCTGA-1	LC_ER-
GTGCTGATCGGTAACT-1	LC_ER-
GTGCTGATCGGTCATG-1	HY_ER+_ER-
GTGCTGATCGGTTTCC-1	LC_ER-
GTGCTGATCTAAGGTC-1	Immature_BC
GTGCTGGGTAACGTGC-1	LC_ER-
GTGCTGGGTGTCCAGG-1	LC_ER-
GTGCTGGGTTACCGGG-1	LC_ER-
GTGCTGGGTTATAGCG-1	Immature_BC
GTGCTGGGTTCGGGAT-1	LC_ER-
GTGCTGGGTTGAGCCG-1	LC_ER+
GTGCTTACATGAAATG-1	HY_ER+_ER-
GTGCTTACATTGTTGG-1	LC_ER+
GTGCTTCTCCGGTATG-1	LC_ER+
GTGCTTCTCTAAGTGC-1	LC_ER-
GTGCTTCTCTAATCTC-1	LC_ER-
GTGGACACACTTGTTC-1	LC_ER+
GTGGACACAGGTTCAC-1	LC_ER-
GTGGACACATCACTTC-1	LC_ER-
GTGGACACATTCCTGT-1	LC_ER+
GTGGATGCACTGGCCA-1	LC_ER+
GTGGATGCACTTGTTC-1	LC_ER-
GTGGATGCATTCCTCG-1	LC_ER+
GTGGCTTCAAACCTAT-1	LC_ER-
GTGTCCAAGCATTTCT-1	LC_ER-
GTGTGAGCAAGGTATA-1	LC_ER+
GTGTGAGCAGGAAGCC-1	LC_ER-
GTGTGAGCATTAAGTC-1	Immature_BC
GTGTGCGGTGGATTAT-1	LC_ER-
GTGTGTTAGAGGAAGG-1	LC_ER+
GTGTGTTAGTAGGATG-1	LC_ER-
GTGTGTTAGTATTGCA-1	LC_ER+
GTGTTACAGATAAAGC-1	LC_ER-
GTGTTACAGCACAGGG-1	LC_ER-
GTGTTACAGGACCTCA-1	LC_ER-
GTGTTACAGGGTCCAC-1	HY_ER+_ER-
GTGTTCCTCACAGCCA-1	LC_ER+
GTTAACCAGCTGTACG-1	LC_ER+
GTTAACGGTGCAATGC-1	Immature_BC
GTTAAGCTCATTGTCT-1	LC_ER+
GTTAAGCTCCATAATG-1	LC_ER-
GTTAAGCTCCCGAACA-1	LC_ER-
GTTAAGCTCCTGATGG-1	LC_ER+
GTTAAGCTCCTTCAAT-1	LC_ER+
GTTAAGCTCTCACAAA-1	LC_ER+
GTTAAGCTCTTGCTAT-1	HY_ER+_ER-
GTTAAGTGTCATCAAG-1	LC_ER-
GTTAATGTCAAGCCTG-1	LC_ER+
GTTAATGTCATCGTTT-1	LC_ER+
GTTAATGTCCATAATG-1	Immature_BC
GTTAATGTCGCACAAT-1	LC_ER-
GTTAATGTCTATGACA-1	LC_ER+
GTTACAGGTACCTTAC-1	LC_ER+
GTTACAGGTCAATACG-1	LC_ER+
GTTACAGGTGCTCCAC-1	LC_ER-
GTTACAGGTTTGGCGG-1	LC_ER+
GTTACAGGTTTGGGCG-1	LC_ER+
GTTACCTGTAACCACA-1	Immature_BC
GTTACCTGTAGGATTT-1	LC_ER+
GTTACCTGTTCCTGTG-1	LC_ER+
GTTACGCCAACCTAAT-1	LC_ER-
GTTACGCCAATATACC-1	LC_ER+
GTTACGCCACTTACAG-1	HY_ER+_ER-
GTTACGCCATTATGAC-1	LC_ER-
GTTACGTAGATAAAGC-1	Immature_BC
GTTACGTAGCCATCAG-1	LC_ER+
GTTACGTAGCGAGTAA-1	LC_ER+
GTTACGTAGGACCGCT-1	HY_BC_ER+
GTTACGTAGGAGGTTA-1	Immature_BC
GTTACGTAGTAAGTCC-1	LC_ER+
GTTACGTAGTGTTGCG-1	LC_ER-
GTTACTAAGCCTGGTA-1	HY_ER+_ER-
GTTACTAAGGAAACTG-1	LC_ER-
GTTACTAAGGAGTAAT-1	LC_ER+
GTTACTAAGGCTAATC-1	LC_ER+
GTTACTCGTTAACAGT-1	LC_ER-
GTTACTCGTTGGTTAG-1	LC_ER-
GTTAGACTCAAGTGTC-1	LC_ER-
GTTAGACTCAGAAACG-1	LC_ER-
GTTAGACTCCAGCACA-1	Immature_BC
GTTAGACTCCCGAACA-1	LC_ER+
GTTAGACTCCGCATGA-1	LC_ER-
GTTAGACTCCTGAGTG-1	LC_ER+
GTTAGACTCGATTTAG-1	LC_ER-
GTTAGGCGTACTTAGG-1	LC_ER+
GTTAGGCGTATTCGTC-1	LC_ER+
GTTAGGCGTCAATACG-1	LC_ER-
GTTAGGCGTGGATTAT-1	LC_ER+
GTTCACCTCAAGCGCC-1	LC_ER-
GTTCACCTCTGCAAAC-1	LC_ER+
GTTCACCTCTTGCAAA-1	LC_ER-
GTTCATTTCAAGCCTG-1	LC_ER+
GTTCATTTCGATTATG-1	LC_ER-
GTTCATTTCTCCATGC-1	LC_ER-
GTTCATTTCTTCAATC-1	Immature_BC
GTTCCCAGTATGGTGC-1	LC_ER+
GTTCCCAGTTTACGTC-1	LC_ER-
GTTCCCAGTTTGCGAA-1	Immature_BC
GTTCCTGGTTCCGGCT-1	LC_ER+
GTTCCTTCAGAGGCTA-1	LC_ER+
GTTCCTTCAGCACGTT-1	LC_ER+
GTTCCTTCAGTAAGTA-1	LC_ER+
GTTCCTTCATAAAGCA-1	LC_ER+
GTTCGCGCAGCAACAG-1	Immature_BC
GTTCGCGCAGTAAGTA-1	LC_ER+
GTTCGCTTCATGGCTG-1	LC_ER-
GTTCGCTTCCGCAAGC-1	LC_ER-
GTTCGCTTCCTCCCTC-1	LC_ER+
GTTCTCATCACTTTAC-1	LC_ER+
GTTCTCATCTTGGATA-1	LC_ER+
GTTCTTAGTAATAACC-1	LC_ER+
GTTCTTAGTGTTTGAG-1	LC_ER+
GTTCTTAGTTAGGCTA-1	LC_ER-
GTTCTTGTCAAACCTA-1	LC_ER+
GTTCTTGTCAATGACC-1	LC_ER+
GTTCTTGTCCAGCACA-1	LC_ER+
GTTCTTGTCCGCAAAT-1	LC_ER-
GTTCTTGTCCTCAGTC-1	LC_ER+
GTTCTTGTCGGTACGC-1	LC_ER+
GTTCTTGTCGGTCATG-1	HY_ER+_ER-
GTTCTTGTCTGTGCCT-1	LC_ER-
GTTGCATAGACAGGTA-1	LC_ER-
GTTGCATAGCATCCAG-1	LC_ER-
GTTGCATAGCCACAAT-1	Immature_BC
GTTGCATAGCTCGCTT-1	Immature_BC
GTTGCATAGTGGCGGA-1	Immature_BC
GTTGCCCGTGGATTGC-1	LC_ER-
GTTGCCCGTTCCTGTG-1	LC_ER+
GTTGCGGGTACAATGT-1	LC_ER+
GTTGCGGGTCATGCAA-1	Immature_BC
GTTGCGGGTTATAGCG-1	LC_ER+
GTTGCGGGTTCGCTTG-1	LC_ER-
GTTGCGGGTTGGTTGA-1	HY_BC_ER+
GTTGCTGAGGATCACT-1	Immature_BC
GTTGCTGAGTATTGCA-1	Immature_BC
GTTGGAGCAACTGGCT-1	LC_ER+
GTTGGAGCAATAGTCT-1	LC_ER+
GTTGGAGCAGGCCATT-1	LC_ER-
GTTGGAGCATGTCAAT-1	LC_ER-
GTTGGAGCATTGTTGG-1	LC_ER-
GTTGGCCAGACAAACG-1	LC_ER+
GTTGGCCAGAGGGACT-1	Immature_BC
GTTGGCCAGCACTAGT-1	LC_ER-
GTTGGCCAGGGATTAG-1	LC_ER+
GTTGGCCAGTAAGTCC-1	LC_ER+
GTTGGCGGTAAAGCAA-1	LC_ER+
GTTGGCGGTACCGGAT-1	LC_ER-
GTTGGCGGTCATAAGT-1	LC_ER+
GTTGTGAGTCGTAAAT-1	LC_ER-
GTTGTGAGTGCTCCAC-1	LC_ER-
GTTGTGAGTTTGCGAA-1	LC_ER+
GTTGTGAGTTTGTCTA-1	Immature_BC
GTTGTTGCAAGCCAGA-1	LC_ER-
GTTGTTGCACAGAACG-1	LC_ER+
GTTGTTGCAGGTCCTG-1	LC_ER+
GTTTAACCAAACATAG-1	LC_ER+
GTTTAACCAACTGGCT-1	LC_ER-
GTTTAACCAATCGCAC-1	LC_ER-
GTTTAACCACAAACTT-1	LC_ER+
GTTTAACCACTATGGC-1	LC_ER-
GTTTAACCATCACAGC-1	LC_ER-
GTTTAACCATGGCCTG-1	LC_ER+
GTTTACCGTACTGATG-1	Immature_BC
GTTTACCGTAGCCTAA-1	LC_ER-
GTTTACCGTAGGATCC-1	LC_ER-
GTTTACCGTATTCGCT-1	Immature_BC
GTTTACCGTCACAGCG-1	HY_ER+_ER-
GTTTACCGTGGTTCTT-1	HY_ER+_ER-
GTTTACCGTTTAGTCC-1	LC_ER-
GTTTAGCAGGTCCAAT-1	LC_ER+
GTTTAGCAGGTTTGCG-1	LC_ER+
GTTTATCTCATCCTAT-1	LC_ER-
GTTTATCTCATGAAGG-1	Immature_BC
GTTTATCTCCGCACAA-1	Immature_BC
GTTTATCTCCTTCGTA-1	HY_ER+_ER-
GTTTATCTCGAAGTAG-1	LC_ER+
GTTTATCTCGCTTCTA-1	LC_ER+
GTTTATCTCTATTGTC-1	LC_ER-
GTTTATCTCTTTGACT-1	LC_ER-
GTTTCAGCAAGACTCC-1	LC_ER-
GTTTCAGCAGGCGAGT-1	LC_ER+
GTTTCAGCATGAAGTA-1	LC_ER+
GTTTCCTCAATAGTCT-1	LC_ER+
GTTTCCTCACAAGCCT-1	LC_ER+
GTTTCCTCAGAGGGAG-1	Immature_BC
GTTTCCTCATAGCAGG-1	LC_ER+
GTTTCCTCATGTTGTG-1	LC_ER+
GTTTCTAGTAGTTACG-1	Immature_BC
GTTTGCTGTGATTACG-1	LC_ER+
GTTTGCTGTTCACCCA-1	LC_ER+
GTTTGCTGTTTGCAGA-1	LC_ER-
GTTTGCTGTTTGCGAA-1	LC_ER-
GTTTGTAAGCCGCAGT-1	LC_ER-
GTTTGTAAGGTAGCTT-1	LC_ER-
GTTTGTAAGTCACTAA-1	LC_ER-
GTTTGTCGTAGCAGCT-1	LC_ER+
GTTTGTCGTGAGCGAA-1	LC_ER-
GTTTGTCGTTCCGGCT-1	LC_ER+
GTTTGTCGTTTAACCC-1	LC_ER-
GTTTGTTTCAAGTGAG-1	LC_ER-
GTTTGTTTCAAGTGTC-1	LC_ER-
GTTTGTTTCATGGTTA-1	LC_ER-
GTTTGTTTCATTACGA-1	LC_ER+
GTTTGTTTCATTCATC-1	Immature_BC
GTTTGTTTCCCTCACG-1	LC_ER+
GTTTGTTTCCCTCGCA-1	LC_ER+
GTTTGTTTCTTGAGGT-1	Immature_BC
TAAACAGCACTTAGGC-1	LC_ER+
TAAACAGCAGTAGCCT-1	LC_ER-
TAAAGCCTCACGAATC-1	LC_ER+
TAAAGCCTCACGCATG-1	LC_ER-
TAAAGCCTCATTATGG-1	LC_ER-
TAAAGCCTCGATTCTT-1	LC_ER+
TAAAGCCTCGCTCACT-1	LC_ER-
TAACAAGCAAAGCGGC-1	Prolif
TAACAAGCAATTTAGC-1	Immature_BC
TAACAAGCACATTAAC-1	LC_ER-
TAACAAGCATGAGTTT-1	LC_ER+
TAACCAGGTATTGTCC-1	LC_ER+
TAACCAGGTCAACAAT-1	HY_ER+_ER-
TAACCAGGTCCTCCAA-1	LC_ER-
TAACCAGGTGGATTAT-1	LC_ER+
TAACCAGGTTAGGCTA-1	LC_ER-
TAACCAGGTTCGCTCA-1	LC_ER+
TAACCGGTCAATGACC-1	LC_ER+
TAACCGGTCATGTTTC-1	LC_ER-
TAACCGGTCCTTTACG-1	LC_ER-
TAACCGGTCGTACCGA-1	LC_ER+
TAACCGGTCTGTGAGT-1	Immature_BC
TAACCGGTCTTAATGG-1	LC_ER+
TAACCTAAGGCGCATC-1	LC_ER-
TAAGCCAGTGTGAGGA-1	Immature_BC
TAAGCCAGTTAGTTGG-1	LC_ER+
TAAGCCTAGCCTCTGT-1	LC_ER+
TAAGCCTAGCTCCTAC-1	LC_ER-
TAAGCCTAGCTGTCAG-1	LC_ER-
TAAGCCTAGGCCATCA-1	LC_ER-
TAAGCCTAGTACTGGT-1	LC_ER-
TAAGCTATCAAACTCA-1	LC_ER-
TAAGCTATCCTCACTA-1	LC_ER+
TAAGCTATCTCCTCAA-1	LC_ER-
TAAGCTGGTAATCGCA-1	LC_ER+
TAAGGACCAAGTAAGC-1	Immature_BC
TAAGGACCACTAAGTT-1	HY_ER+_ER-
TAAGGCTTCCCAGTAG-1	LC_ER+
TAAGGCTTCCCGTTAC-1	HY_BC_ER+
TAAGGCTTCTTAGCGG-1	LC_ER+
TAAGTAGCACATTGCA-1	LC_ER-
TAAGTAGCACTGACTA-1	LC_ER-
TAAGTAGCAGATAGAC-1	LC_ER+
TAAGTAGCATGATTGT-1	LC_ER-
TAAGTGCTCATGGCCA-1	LC_ER+
TAAGTGCTCATGGTTA-1	LC_ER+
TAAGTGCTCCAGGGAG-1	LC_ER-
TAAGTGCTCTTTGTAC-1	LC_ER+
TAATCACCACAATACT-1	LC_ER+
TAATCACCACAGACTC-1	LC_ER-
TAATCCGCAAACGCGA-1	LC_ER-
TAATCCGCACTAGCGT-1	LC_ER+
TAATGCATCAATCATG-1	LC_ER-
TAATGCATCCAGCACA-1	HY_ER+_ER-
TAATGCATCCGGCTAA-1	LC_ER+
TAATGCATCGCATTAA-1	HY_ER+_ER-
TAATGCATCGCTCACT-1	LC_ER+
TAATGGACAAGTGAAC-1	LC_ER-
TAATGGACATCGTTCT-1	LC_ER-
TAATGGTGTGAATCGC-1	LC_ER-
TAATTGCCACTAGGTC-1	Immature_BC
TACAACATCCGGTTGA-1	LC_ER-
TACAACATCCTACCTA-1	Immature_BC
TACAACATCTTGGACG-1	LC_ER+
TACAACATCTTTAAGG-1	LC_ER+
TACAAGCTCCGCCTAT-1	LC_ER-
TACAAGCTCCTTGAGG-1	LC_ER+
TACAAGCTCTTAGGAC-1	LC_ER-
TACAATGTCCTGATGG-1	LC_ER+
TACAGCTAGGACAATG-1	LC_ER+
TACAGGTTCAATTACG-1	LC_ER-
TACAGGTTCATGGTGT-1	LC_ER-
TACATCAAGGGATTAG-1	LC_ER-
TACATCAAGGGCCATC-1	LC_ER-
TACATCAAGTAACGGA-1	LC_ER+
TACATCAAGTTATGGC-1	Immature_BC
TACATCAAGTTTCCGC-1	LC_ER+
TACCAAATCATCCACC-1	LC_ER+
TACCAAATCCGCCTCA-1	LC_ER-
TACCAGGTCGATTCTT-1	HY_ER+_ER-
TACCAGGTCTGTTCAT-1	HY_BC_ER+
TACCCGGCAAATGCCC-1	LC_ER+
TACCCGGCAAGCCAGA-1	LC_ER-
TACCCGGCAAGTGAAC-1	LC_ER+
TACCCGGCACAAAGAC-1	LC_ER-
TACCCGGCATGTCGCG-1	LC_ER+
TACCGCAAGGAACACA-1	LC_ER-
TACCGCAAGGACTTAC-1	LC_ER-
TACCGTTGTTAGGTTG-1	LC_ER-
TACCGTTGTTGGGTTA-1	LC_ER-
TACCTCATCATTGTTC-1	LC_ER-
TACCTCATCGTTCACC-1	Immature_BC
TACCTGCTCCATAATG-1	Immature_BC
TACCTGCTCCATCAGG-1	HY_ER+_ER-
TACCTGCTCCCGTTGT-1	Immature_BC
TACCTGCTCTCCTCAA-1	LC_ER+
TACCTGCTCTGCAACG-1	LC_ER+
TACCTGCTCTTACTCG-1	LC_ER+
TACCTTAGTCCGTGAG-1	LC_ER+
TACCTTAGTCTAGCTT-1	LC_ER+
TACCTTTAGAGAGGAG-1	LC_ER-
TACCTTTAGCAACATC-1	LC_ER+
TACGCACCACCAGGTT-1	LC_ER-
TACGCACCACGAATCC-1	LC_ER-
TACGCACCATAATCCG-1	LC_ER-
TACGCACCATGCTCCC-1	LC_ER-
TACGCTTGTGAGAAAC-1	LC_ER-
TACGCTTGTTAGGACC-1	LC_ER-
TACGCTTGTTTGCGAA-1	HY_BC_ER+
TACGGATTCCCTCTAA-1	LC_ER+
TACGGATTCTCTAGCC-1	LC_ER+
TACGGTTAGAGAAGGG-1	LC_ER-
TACGGTTAGGTCAAAG-1	HY_BC_ER+
TACGGTTAGTCATCCC-1	Immature_BC
TACGTAATCAACAAGG-1	LC_ER-
TACGTAATCCTAAATG-1	LC_ER+
TACGTAATCGGTAACT-1	LC_ER+
TACGTAATCTAGCTAA-1	LC_ER-
TACGTAATCTGTAATG-1	Immature_BC
TACGTACAGCACTTGG-1	Immature_BC
TACGTACAGCTCAAAC-1	Immature_BC
TACGTACAGTAGCTTA-1	LC_ER-
TACGTTAAGGAAGCTA-1	LC_ER-
TACGTTAAGGAGTAAT-1	LC_ER+
TACGTTAAGGCAATAG-1	LC_ER-
TACGTTAAGGCCCAGT-1	LC_ER+
TACGTTAAGGCCTGGT-1	Immature_BC
TACGTTAAGTAACGAG-1	LC_ER+
TACGTTAAGTCCTTTG-1	LC_ER+
TACTAAGTCATCCACC-1	LC_ER-
TACTAAGTCCGCCTAT-1	LC_ER+
TACTAAGTCCTAAGTA-1	Immature_BC
TACTAAGTCCTCATCA-1	LC_ER-
TACTAAGTCCTGGTGA-1	Immature_BC
TACTAAGTCCTTGCGT-1	LC_ER+
TACTAAGTCGCCTGTT-1	LC_ER-
TACTAAGTCGGCTAGC-1	LC_ER-
TACTAAGTCTAATCAG-1	Immature_BC
TACTAAGTCTTAGGAC-1	HY_ER+_ER-
TACTAAGTCTTGCAAA-1	LC_ER-
TACTCAAAGCAAGACA-1	LC_ER-
TACTCAAAGCCTCTCG-1	LC_ER-
TACTCAAAGGAAGTAT-1	LC_ER+
TACTCAAAGGGTGGAT-1	LC_ER-
TACTCAAAGTCACTCC-1	LC_ER+
TACTCGCTCCTAGTAA-1	LC_ER-
TACTCGCTCCTGGTCT-1	Immature_BC
TACTGACAGCAGCTAT-1	Immature_BC
TACTGACAGCTCCTTA-1	LC_ER-
TACTGACAGGCTGTCA-1	LC_ER+
TACTGACAGGCTGTGC-1	LC_ER+
TACTGACAGGTCAAAG-1	LC_ER+
TACTGACAGGTGAAGC-1	Immature_BC
TACTGAGGTTAACAGT-1	LC_ER-
TACTGAGGTTACCTGT-1	Immature_BC
TACTGAGGTTAGAGGG-1	LC_ER+
TACTGAGGTTTGAGGC-1	LC_ER+
TACTGCACACGTTACA-1	LC_ER-
TACTGCACAGTACCGT-1	LC_ER-
TACTGCACATCACAGC-1	Immature_BC
TACTGCACATTGTCAG-1	LC_ER+
TACTGGCCAAGGTGCA-1	LC_ER+
TACTGGCCAAGTGTTT-1	LC_ER+
TACTGGCCACCAACCG-1	LC_ER+
TACTGGCCATAAAGCA-1	LC_ER+
TACTGGCCATGCATAT-1	LC_ER-
TACTGGCCATTCCTGT-1	HY_BC_ER+
TACTTCGTCACCTGTC-1	Immature_BC
TACTTCGTCATCAGTA-1	Immature_BC
TACTTCGTCCCTGATC-1	Immature_BC
TACTTCGTCCTAAGAC-1	LC_ER-
TACTTCGTCGCAAACT-1	LC_ER+
TACTTCGTCGGGCCAT-1	LC_ER-
TACTTCGTCGTAACGT-1	LC_ER+
TACTTCGTCGTTTCTG-1	Immature_BC
TACTTGTTCACCATTT-1	LC_ER+
TACTTGTTCATTGCGG-1	LC_ER+
TACTTGTTCCCGAACA-1	LC_ER-
TACTTGTTCTCAATGA-1	LC_ER-
TACTTGTTCTTAGCGG-1	Immature_BC
TAGACCAGTCACACCC-1	LC_ER+
TAGAGCCGTATTGGTG-1	LC_ER-
TAGAGCCGTCAAAGGG-1	LC_ER+
TAGAGCCGTCACCTAT-1	LC_ER+
TAGAGCCGTGAGCAAG-1	LC_ER+
TAGAGCCGTTTAGCTC-1	Immature_BC
TAGCAGGCAAAGCTAA-1	LC_ER+
TAGCAGGCAACCCTCC-1	LC_ER-
TAGCAGGCACAATGCC-1	Immature_BC
TAGCAGGCACTGACCG-1	LC_ER+
TAGCAGGCAGGCGATA-1	LC_ER+
TAGCAGGCAGGTTCAC-1	LC_ER-
TAGCAGGCATTTAAGC-1	Immature_BC
TAGCATATCGTTATCT-1	Immature_BC
TAGCATATCTTGCTAT-1	LC_ER+
TAGCATATCTTGGATA-1	LC_ER+
TAGCCGGGTACTTAGG-1	LC_ER+
TAGCCGGGTTAGCGTA-1	LC_ER+
TAGCCGGGTTGGCCGA-1	Immature_BC
TAGCCTCTCGGTCAGC-1	LC_ER+
TAGCCTCTCTCCATGC-1	LC_ER-
TAGCCTGAGAGAGGAG-1	HY_ER+_ER-
TAGCCTGAGCTGGACC-1	LC_ER+
TAGCCTGAGGCAGGTG-1	LC_ER-
TAGCCTGAGTATTGGC-1	LC_ER-
TAGCCTGAGTGGACAA-1	LC_ER-
TAGCCTTGTACCGAAC-1	LC_ER+
TAGCCTTGTGCCGCAA-1	LC_ER+
TAGCCTTGTTTACCGT-1	Immature_BC
TAGCGCGGTGATGAGG-1	LC_ER-
TAGCGGACAACATAAG-1	LC_ER-
TAGCGGACACTAAGTT-1	LC_ER-
TAGCGGACAGCAAATA-1	LC_ER-
TAGCGGACAGGCATGA-1	LC_ER+
TAGCGGACAGGCTGTT-1	LC_ER-
TAGCGGACATCCCTCA-1	LC_ER-
TAGCGGCTCATTACTC-1	LC_ER-
TAGCGGCTCCCGCATT-1	LC_ER-
TAGCGGCTCGCTAAAC-1	Immature_BC
TAGCGGCTCGGCCAGT-1	HY_ER+_ER-
TAGCGGCTCGTTAGTA-1	LC_ER+
TAGCTAATCGGTTCCT-1	LC_ER+
TAGCTAATCTATTGTC-1	LC_ER+
TAGCTAGGTGCTTACT-1	LC_ER-
TAGCTAGGTTCCGGGA-1	LC_ER+
TAGCTAGGTTTGGGCG-1	LC_ER+
TAGCTTAAGCTAAGTC-1	LC_ER+
TAGCTTAAGCTGGACC-1	LC_ER-
TAGCTTAAGTCACCAG-1	LC_ER-
TAGCTTGCATAGCAGG-1	LC_ER-
TAGCTTGCATTCCTGT-1	LC_ER+
TAGGAACCACCGGTAT-1	Immature_BC
TAGGAACCACGGTACT-1	HY_ER+_ER-
TAGGAACCATACTCCT-1	LC_ER-
TAGGAACCATGGCCTG-1	LC_ER+
TAGGAGGGTTATAGCG-1	LC_ER-
TAGGAGTCAACTAACT-1	LC_ER-
TAGGAGTCAGGCCATT-1	LC_ER-
TAGGAGTCATTGCGTA-1	Immature_BC
TAGGCTAGTAATGGCC-1	LC_ER-
TAGGCTAGTGTCCAGG-1	HY_BC_ER+
TAGGCTAGTTGTGATG-1	LC_ER+
TAGGCTTAGCTAAGTC-1	Immature_BC
TAGGCTTAGTAGGCGG-1	LC_ER-
TAGGCTTAGTTAACCA-1	LC_ER+
TAGGGTTTCAGCAAAG-1	HY_BC_ER+
TAGGGTTTCCCGTTTA-1	LC_ER+
TAGGGTTTCCGGTTAG-1	LC_ER-
TAGGGTTTCTTAGGGT-1	LC_ER+
TAGGTGCGTCAAAGAA-1	LC_ER+
TAGGTGCGTCATGCCC-1	LC_ER+
TAGGTGCGTGCTCACC-1	LC_ER+
TAGGTGCGTGCTGGTG-1	LC_ER+
TAGGTGCGTTAGCGTA-1	Immature_BC
TAGGTGCGTTCACCAT-1	LC_ER-
TAGGTTATCAAGCCTG-1	LC_ER-
TAGGTTATCTTGTCTG-1	HY_ER+_ER-
TAGGTTGGTCGTTATC-1	LC_ER-
TAGGTTGGTTGGTTCT-1	LC_ER+
TAGTAACGTAAGGTTT-1	LC_ER-
TAGTAACGTAGGTGTC-1	LC_ER+
TAGTAACGTAGTAAGA-1	LC_ER+
TAGTAACGTGATGAGG-1	LC_ER-
TAGTAACGTGCAACTA-1	LC_ER+
TAGTAAGCACTTACAG-1	LC_ER-
TAGTAAGCATCATGGC-1	LC_ER-
TAGTAAGCATCCCTCA-1	LC_ER+
TAGTAAGCATGGAGGC-1	LC_ER+
TAGTACGGTCAGGCAT-1	LC_ER-
TAGTACGGTCGCGCAA-1	LC_ER-
TAGTACGGTTGTTCAC-1	LC_ER+
TAGTACGGTTTGAGGC-1	LC_ER+
TAGTAGGAGCGCCTAA-1	LC_ER+
TAGTAGGAGCGGCTGT-1	LC_ER+
TAGTAGGAGTCAATTG-1	LC_ER-
TAGTCAATCATCCACC-1	LC_ER+
TAGTCAATCATTCATC-1	LC_ER-
TAGTCAATCCTTAAGA-1	Immature_BC
TAGTCAATCGAGCTAT-1	Immature_BC
TAGTCAATCGCAAACT-1	LC_ER+
TAGTCAATCTGTGAGT-1	HY_ER+_ER-
TAGTGAGAGAGCCGGA-1	LC_ER+
TAGTGAGAGCCAGTAT-1	LC_ER+
TAGTGAGAGTGAACAG-1	Immature_BC
TAGTGAGAGTGACCTG-1	LC_ER+
TAGTGAGAGTTGTCTT-1	LC_ER+
TAGTGGCGTACTGATG-1	Immature_BC
TAGTGGCGTCATCATC-1	LC_ER-
TAGTGGCGTCCGTAGG-1	LC_ER-
TAGTGGCGTCTAACCT-1	LC_ER-
TAGTGGCGTTCACTGT-1	HY_ER+_ER-
TAGTGTGGTCCTAACT-1	LC_ER-
TAGTGTGGTGCAATGC-1	LC_ER-
TAGTGTGGTGGAGCAA-1	LC_ER+
TAGTTGTCAGCATGGA-1	LC_ER-
TAGTTGTCATCGCTTT-1	LC_ER+
TAGTTTGAGAACCTAC-1	LC_ER-
TAGTTTGAGTCACGAT-1	LC_ER+
TAGTTTGAGTTCCTGC-1	Immature_BC
TATAACCCAATAATCC-1	LC_ER-
TATAACCCATTAAGTC-1	LC_ER-
TATAGCCAGATGCCTG-1	LC_ER-
TATAGCCAGCTAATCA-1	LC_ER-
TATAGCCAGTAAGTCC-1	LC_ER+
TATAGCTCACCTGCTC-1	LC_ER+
TATAGCTCAGAAATTG-1	Immature_BC
TATAGCTCAGGAAGCC-1	LC_ER+
TATAGCTCAGGCTTCG-1	LC_ER+
TATAGCTCAGTTAAAG-1	LC_ER+
TATAGCTCATAGCAGG-1	LC_ER+
TATAGGTGTAAAGCAA-1	LC_ER+
TATAGGTGTCTCACTG-1	Immature_BC
TATAGGTGTTAATGCG-1	LC_ER+
TATAGGTGTTACTTCA-1	Immature_BC
TATATCCTCCGGTTAG-1	HY_ER+_ER-
TATATCCTCCTGATTT-1	LC_ER-
TATATCCTCGCATCCT-1	LC_ER-
TATATCCTCGTTATAG-1	LC_ER-
TATATCCTCTCAATGA-1	LC_ER+
TATCACAAGCTTAGCG-1	Immature_BC
TATCACAAGGGTTAGA-1	LC_ER+
TATCACAAGTAAAGGT-1	Immature_BC
TATCACAAGTTTCCGC-1	Immature_BC
TATCACGCATAGCGAG-1	Immature_BC
TATCACGCATTAGGTT-1	LC_ER+
TATCCAGCAAAGCGCA-1	LC_ER-
TATCCAGCAGGCATGA-1	LC_ER+
TATCCAGCATAGCGAG-1	LC_ER-
TATCCGGAGCACAGAA-1	HY_ER+_ER-
TATCCGGAGTAAAGGT-1	LC_ER+
TATCCGGAGTGTGATC-1	Immature_BC
TATCGAGGTAATTAGC-1	HY_ER+_ER-
TATCGAGGTAGCAGCT-1	HY_ER+_ER-
TATCGAGGTGGAAACG-1	LC_ER-
TATCGAGGTTGCGCGA-1	LC_ER-
TATCGAGGTTTGACCT-1	HY_ER+_ER-
TATCGCACAATTGACT-1	LC_ER-
TATCGCACACTAAATC-1	LC_ER+
TATCGCACAGCAGGTA-1	LC_ER+
TATCGCACATGAGTTT-1	LC_ER-
TATCGCGAGATAGACG-1	Immature_BC
TATCGCGAGCCAGGTC-1	LC_ER+
TATCGCGAGCCTGATG-1	HY_ER+_ER-
TATCGCGAGTGATTCA-1	LC_ER+
TATCGCGAGTTGCGTG-1	Immature_BC
TATGAAGCAAGCCAGA-1	LC_ER-
TATGACATCCGCCTAT-1	Immature_BC
TATGACATCCGGTTAG-1	LC_ER-
TATGACATCGAGGAGT-1	LC_ER+
TATGACATCGATTATG-1	LC_ER-
TATGACATCTTGGACG-1	Immature_BC
TATGACATCTTGTCTG-1	LC_ER-
TATGACATCTTGTTCG-1	LC_ER-
TATGACTCAATAATGG-1	LC_ER+
TATGACTCACACAATT-1	Immature_BC
TATGACTCAGGTTACC-1	LC_ER-
TATGACTCAGTCTAGC-1	LC_ER-
TATGCATCAAGTAAGC-1	LC_ER-
TATGGATGTCCAAGAC-1	LC_ER-
TATGGATGTGATTACG-1	LC_ER+
TATGGATGTTCCTGTG-1	LC_ER+
TATGGCCCAAGCTAAA-1	HY_ER+_ER-
TATGGCCCACACCAAC-1	LC_ER-
TATGGCCCATTGCGAC-1	LC_ER+
TATGGGCGTAGCTGGT-1	LC_ER-
TATGGGCGTTTCCTCC-1	LC_ER-
TATGGTCAGCCTTAAA-1	LC_ER+
TATGGTCAGCTCGCTT-1	LC_ER-
TATGGTCAGGTCCTGA-1	Immature_BC
TATGTGATCCCTCAAC-1	LC_ER+
TATGTGATCCTAACGG-1	LC_ER+
TATGTGATCGCCTAAG-1	LC_ER-
TATTACCTCACCGGTA-1	LC_ER+
TATTACCTCAGTTCCC-1	LC_ER-
TATTACCTCCGTCCAT-1	Immature_BC
TATTACCTCCTGGCTT-1	Immature_BC
TATTACCTCTCACTAT-1	LC_ER+
TATTAGCCAAGACTCC-1	LC_ER-
TATTAGCCACAAACTT-1	LC_ER-
TATTAGCCAGGATTAA-1	LC_ER+
TATTAGCCAGTTGCGT-1	LC_ER-
TATTAGCCATAGCGGA-1	LC_ER-
TATTAGGTCCGTGACA-1	LC_ER-
TATTAGGTCCTTAGGG-1	Immature_BC
TATTAGGTCGACAAAG-1	Immature_BC
TATTAGGTCGCCTAAG-1	LC_ER-
TATTCGTTCATCCTAT-1	LC_ER+
TATTCGTTCCGGTATG-1	LC_ER+
TATTCGTTCGGGATTT-1	Immature_BC
TATTCGTTCTTAGCCC-1	HY_BC_ER+
TATTCGTTCTTGATGA-1	LC_ER+
TATTGACCATCCTGAA-1	LC_ER-
TATTTGCTCCCTGGAA-1	LC_ER-
TATTTGCTCTTGCAAA-1	LC_ER+
TATTTGGAGCACAGAA-1	LC_ER-
TATTTGGAGCACTTGG-1	LC_ER+
TATTTGGAGCCGGTAC-1	LC_ER+
TATTTGGAGTAAACCC-1	LC_ER+
TATTTGGAGTCACCAG-1	HY_ER+_ER-
TATTTGGAGTCATTTC-1	LC_ER+
TATTTGGAGTGGACAA-1	LC_ER+
TCAAACCAGACAGGTA-1	LC_ER+
TCAAACCAGCTTATGA-1	LC_ER+
TCAAACCAGGCCGGAA-1	LC_ER-
TCAAACCAGGTAACGA-1	LC_ER-
TCAACAATCAATCATG-1	LC_ER+
TCAACAATCCTTAGTT-1	LC_ER+
TCAACAATCTGTAATG-1	LC_ER+
TCAACAATCTTGGACG-1	LC_ER-
TCAAGAACAAGCTTAT-1	Immature_BC
TCAAGAACAATAGTCT-1	LC_ER-
TCAAGAACAATCTCTC-1	HY_ER+_ER-
TCAAGAACACCAAAGG-1	LC_ER-
TCAAGAACACTGACCG-1	LC_ER-
TCAAGAACAGTTTGTG-1	LC_ER+
TCAAGAACATAGACCC-1	Immature_BC
TCAAGAACATGCTTAG-1	LC_ER-
TCAAGACTCAGGCTAT-1	LC_ER+
TCAAGACTCGCTCCAT-1	LC_ER+
TCAAGACTCTGTGCCT-1	LC_ER+
TCAAGCTAGAATCTCA-1	LC_ER+
TCAAGCTAGACAAAGT-1	HY_ER+_ER-
TCAAGCTAGCTAATCA-1	LC_ER-
TCAAGCTAGCTTAACA-1	Immature_BC
TCAAGCTAGGCATGTT-1	LC_ER+
TCAAGCTAGTAGGCGG-1	LC_ER+
TCAAGCTAGTTATTCC-1	LC_ER-
TCAAGGAAGCTGAGGG-1	LC_ER-
TCAAGGAAGGATCCGC-1	LC_ER-
TCAAGGAAGGTCCTGA-1	Immature_BC
TCAAGGAAGTAACCAC-1	LC_ER+
TCAAGGAAGTTCCCAC-1	LC_ER+
TCAAGGTTCACCATTT-1	HY_BC_ER+
TCAAGGTTCCCTCACG-1	LC_ER+
TCAAGGTTCGTAACGT-1	LC_ER-
TCAAGTATCCTGAGTG-1	LC_ER+
TCAAGTATCGCTAGCA-1	Immature_BC
TCAAGTATCTGTTGCC-1	LC_ER-
TCAATCGCAAGGGTTG-1	LC_ER+
TCAATCGCACAAAGCG-1	LC_ER-
TCAATCGCATAGGCGA-1	LC_ER+
TCAATCGCATTTAAGC-1	LC_ER+
TCACATAAGCACTTGG-1	LC_ER-
TCACATAAGCTGGACC-1	LC_ER+
TCACATAAGGAGGACT-1	Immature_BC
TCACATAAGGTCCTAG-1	LC_ER-
TCACCGGCAAGCCACT-1	LC_ER+
TCACCGGCAATAATCC-1	LC_ER+
TCACCTCAGCAAGATG-1	LC_ER-
TCACCTCAGGATTGAG-1	HY_ER+_ER-
TCACCTGGTGCTAGAC-1	LC_ER-
TCACCTGGTGCTCCAC-1	LC_ER-
TCACCTGGTGTTCCCA-1	LC_ER+
TCACTGACACAATACT-1	LC_ER+
TCACTGACACAGAAAC-1	LC_ER-
TCACTGACACTAAGTT-1	LC_ER+
TCACTGACACTATGGC-1	Immature_BC
TCACTGACAGGGAGGA-1	HY_ER+_ER-
TCAGCAAGTTAGGCTA-1	Immature_BC
TCAGCAAGTTTGACCT-1	LC_ER+
TCAGCCTTCACTAGGT-1	Immature_BC
TCAGCCTTCATGTTTC-1	HY_ER+_ER-
TCAGCCTTCCCTGGTT-1	LC_ER-
TCAGCCTTCCTAGTTT-1	LC_ER-
TCAGCGATCACCTGTC-1	LC_ER+
TCAGCGATCTCAATTC-1	LC_ER+
TCAGGAGCAAATTCGT-1	LC_ER-
TCAGGAGCACGTGCTG-1	LC_ER-
TCAGGAGCAGTAAAGC-1	LC_ER+
TCAGGTCCACACTAAT-1	LC_ER+
TCAGGTCCAGGCGATA-1	LC_ER+
TCAGGTCCAGTACCGT-1	LC_ER+
TCAGGTTAGCCGGTAC-1	HY_BC_ER+
TCAGGTTAGCTGTAAC-1	LC_ER+
TCAGGTTAGGAGCACG-1	LC_ER+
TCAGGTTAGGGTGAGT-1	LC_ER+
TCAGTAATCAAGACTC-1	LC_ER-
TCAGTAATCAATGAGG-1	LC_ER-
TCAGTAATCAGCATTA-1	LC_ER+
TCAGTAATCCTTGCAC-1	LC_ER-
TCAGTAATCGAAGTGA-1	LC_ER+
TCAGTAGGTCACGGAT-1	Immature_BC
TCAGTAGGTGGAAACG-1	LC_ER-
TCAGTAGGTTGACTTC-1	LC_ER-
TCAGTGAGTAAGGTCC-1	LC_ER-
TCAGTGAGTAGGATTT-1	LC_ER-
TCAGTGAGTCCTAAGA-1	LC_ER+
TCAGTGAGTTGACTTC-1	LC_ER-
TCAGTGAGTTGGGTTA-1	LC_ER-
TCAGTGAGTTGTTCAC-1	LC_ER-
TCAGTGAGTTTACCGT-1	LC_ER+
TCATAACCAACATAAG-1	LC_ER+
TCATAACCAATACTGT-1	Immature_BC
TCATAACCAGCAGGTA-1	LC_ER-
TCATAACCATAAGTCT-1	LC_ER-
TCATAACCATGGTTAT-1	LC_ER-
TCATAACCATGTTGGC-1	Immature_BC
TCATACTTCATGCCTC-1	LC_ER+
TCATACTTCCCTCAGT-1	LC_ER+
TCATACTTCGAGGAAC-1	Immature_BC
TCATACTTCTGTGAGT-1	LC_ER-
TCATCCATCCCTGACT-1	LC_ER-
TCATCCATCTGTAATG-1	Immature_BC
TCATCCATCTGTTGCC-1	LC_ER-
TCATGAGGTCAAAGAA-1	LC_ER-
TCATGAGGTCATCAAG-1	HY_ER+_ER-
TCATGAGGTCCTTTAA-1	Immature_BC
TCATGAGGTTTGGGTA-1	LC_ER-
TCATGCCTCAAGCTAC-1	LC_ER+
TCATGCCTCATGCAAC-1	LC_ER+
TCATGCCTCCTCATCA-1	LC_ER-
TCATGCCTCGAGGAAC-1	HY_ER+_ER-
TCATGCCTCTAGCTTT-1	LC_ER-
TCATGTTTCAGGCCTA-1	Immature_BC
TCATGTTTCGTTAAGC-1	LC_ER+
TCATGTTTCTGCAAGT-1	LC_ER-
TCATGTTTCTTTAAGG-1	Immature_BC
TCATTACTCCCTCAAC-1	Immature_BC
TCATTACTCGGTCAAT-1	LC_ER-
TCATTACTCGTTAGTA-1	LC_ER+
TCATTACTCTGTGCCT-1	HY_ER+_ER-
TCATTACTCTTCAATC-1	HY_ER+_ER-
TCATTGTTCACCGGTA-1	LC_ER+
TCATTGTTCCTTGCAC-1	LC_ER-
TCATTTGGTAAACAAG-1	LC_ER-
TCATTTGGTCCTTAGT-1	Immature_BC
TCATTTGGTGAAGCCT-1	Immature_BC
TCCACAACAATAGCCC-1	LC_ER+
TCCACAACACCCACCT-1	Immature_BC
TCCACAACATGAAGTA-1	LC_ER+
TCCAGCAAGACTATTG-1	LC_ER+
TCCAGCAAGCTTGCTC-1	LC_ER-
TCCAGCAAGGTGAAGC-1	LC_ER-
TCCAGCAAGTAAACCC-1	Immature_BC
TCCAGCAAGTGCTGTG-1	LC_ER+
TCCAGGATCCCATAAA-1	LC_ER-
TCCAGGATCCTTAGGG-1	LC_ER-
TCCAGGATCTAGCTAA-1	LC_ER-
TCCAGGATCTGGTCCT-1	LC_ER-
TCCAGGTCAACAACAA-1	HY_ER+_ER-
TCCAGGTCAATTGAAG-1	LC_ER+
TCCATAAAGAATCGCT-1	LC_ER+
TCCATAAAGGAACGGT-1	LC_ER+
TCCATAAAGGTTAGCT-1	LC_ER+
TCCATAAAGTGAACCT-1	LC_ER-
TCCATATTCACTAAGC-1	LC_ER-
TCCATCATCAAGCGCC-1	LC_ER+
TCCATCATCATAAGCC-1	LC_ER-
TCCATCATCTAAGTCA-1	LC_ER-
TCCATCATCTCACTAT-1	LC_ER+
TCCATCATCTGTTCAT-1	LC_ER+
TCCATCATCTTAAGTG-1	LC_ER-
TCCATGCTCAAGCTAC-1	Immature_BC
TCCATGCTCAGAAACG-1	LC_ER-
TCCATGCTCATCACTT-1	LC_ER-
TCCATGCTCCTGAGTG-1	LC_ER-
TCCATGCTCGGGACCT-1	LC_ER-
TCCATGCTCTTGTTCG-1	Immature_BC
TCCATTGTCACGCCAA-1	LC_ER-
TCCATTGTCCTGGTGA-1	Immature_BC
TCCATTGTCGCCTAAG-1	Immature_BC
TCCCGGACAGCAAGTG-1	LC_ER-
TCCCGGACAGCATGGA-1	LC_ER-
TCCCGGACATTATGGT-1	LC_ER+
TCCCGGACATTTGCTC-1	LC_ER+
TCCCGTTAGACTATTG-1	LC_ER+
TCCCGTTAGCCTGACA-1	LC_ER+
TCCCGTTAGGCGCACT-1	LC_ER-
TCCCGTTAGGGTTATC-1	LC_ER-
TCCCGTTAGTGAACAG-1	LC_ER+
TCCCGTTAGTTCCCGT-1	LC_ER+
TCCCTCACAAACCCTA-1	HY_ER+_ER-
TCCCTCACAATAGCCC-1	LC_ER+
TCCCTCACACTAAGAA-1	LC_ER-
TCCCTCACAGTTTCTC-1	HY_ER+_ER-
TCCCTGGTCGATATTG-1	LC_ER+
TCCCTGGTCGTTAAGC-1	LC_ER-
TCCGCCATCACCATTT-1	LC_ER+
TCCGCCATCCAGGTCA-1	LC_ER+
TCCGCCATCCCTCGCA-1	LC_ER-
TCCGCCATCGCAACAT-1	LC_ER-
TCCGCCATCGCCTGTT-1	LC_ER-
TCCGCCATCTGTTGCC-1	LC_ER+
TCCGGAATCCATCAGG-1	LC_ER-
TCCGGAATCGATTCTT-1	Immature_BC
TCCGGTAAGGCGGATG-1	LC_ER-
TCCGGTAAGTAGCGGG-1	LC_ER-
TCCGGTAAGTGAACCT-1	LC_ER-
TCCTAGTGTAATCGGC-1	LC_ER-
TCCTAGTGTTATCCGT-1	LC_ER-
TCCTCAATCCACCTTA-1	LC_ER+
TCCTCAATCCCTCAGT-1	LC_ER+
TCCTCAATCGCACAAT-1	LC_ER+
TCCTCAATCTTGCATT-1	HY_ER+_ER-
TCCTCACAGCCTTAAA-1	LC_ER+
TCCTCACAGGCTGTGC-1	LC_ER-
TCCTCACAGTAATCCA-1	LC_ER-
TCCTCACAGTTTGCGG-1	LC_ER-
TCCTCTAAGAGCAAGC-1	HY_ER+_ER-
TCCTGGTTCCAACTGG-1	LC_ER+
TCCTGGTTCCGGTATG-1	LC_ER+
TCCTGGTTCTCATCAT-1	Immature_BC
TCCTGTTCACACAATT-1	LC_ER+
TCCTGTTCATGACTAT-1	Immature_BC
TCCTTAGTCAATCATG-1	LC_ER-
TCCTTAGTCGTACCGA-1	LC_ER+
TCCTTAGTCGTCAAGT-1	LC_ER+
TCCTTCAAGGAAGTAT-1	LC_ER-
TCCTTCAAGGCAAGTA-1	Immature_BC
TCCTTCAAGTAAGTGG-1	LC_ER+
TCCTTGCAGGTTTACA-1	LC_ER+
TCCTTGCAGTTATTCC-1	LC_ER+
TCCTTTACAAAGCTAA-1	LC_ER-
TCCTTTACACAGGGAC-1	LC_ER+
TCCTTTACACCTGGTG-1	LC_ER-
TCCTTTACAGAAATGC-1	LC_ER-
TCCTTTACAGCAAGGC-1	HY_ER+_ER-
TCCTTTACAGGTTCAC-1	LC_ER-
TCCTTTACATAATTGC-1	LC_ER+
TCGACAAGTAAGGTTT-1	LC_ER-
TCGACAAGTCTAGCTT-1	LC_ER-
TCGACAAGTTTATCGC-1	LC_ER+
TCGATTAAGCACTAAC-1	LC_ER+
TCGATTAAGGACCTGC-1	HY_ER+_ER-
TCGATTAAGGTGAAGC-1	LC_ER+
TCGATTAAGTAACGGA-1	LC_ER+
TCGATTAAGTTGGGCC-1	LC_ER-
TCGCATTGTCGCAATA-1	LC_ER+
TCGCATTGTGTTGTAG-1	LC_ER+
TCGCATTGTTGTCCAT-1	LC_ER-
TCGCATTGTTGTTCAC-1	Immature_BC
TCGCCCATCAGCAAAG-1	Immature_BC
TCGCCCATCGTTACAA-1	LC_ER+
TCGCGAGGTAAGGTCC-1	Immature_BC
TCGCGAGGTTAGCAGC-1	LC_ER-
TCGCGAGGTTTAAAGC-1	LC_ER+
TCGCGCACAAGGTCCT-1	LC_ER+
TCGCGCACAGTAGGTG-1	LC_ER+
TCGCGCACATCCGTAA-1	HY_ER+_ER-
TCGCGCACATGTTGGC-1	HY_BC_ER+
TCGCGCACATTAAGCT-1	LC_ER-
TCGCGCACATTGACAT-1	Immature_BC
TCGCTAACAATAATCC-1	Immature_BC
TCGCTAACAGGCCATT-1	Immature_BC
TCGGTAAGTAAGCTTG-1	LC_ER+
TCGGTAAGTTTGTTGC-1	LC_ER-
TCGGTTACACACAATT-1	LC_ER-
TCGGTTACAGGATTAA-1	HY_ER+_ER-
TCGGTTACAGTAGGAT-1	LC_ER-
TCGGTTCTCCCTGGTT-1	Immature_BC
TCGGTTCTCGAGGTGG-1	LC_ER-
TCGGTTCTCTAACTGA-1	LC_ER+
TCGGTTTGTAGGTTAT-1	LC_ER+
TCGTAATCAAAGCGGC-1	LC_ER+
TCGTAATCACACAATT-1	LC_ER+
TCGTAATCATAGCTGC-1	LC_ER+
TCGTCAACAGCCTAAC-1	LC_ER-
TCGTCAACAGCTCATA-1	LC_ER+
TCGTCAACATAAGTCT-1	LC_ER+
TCGTGCTTCATAGACC-1	LC_ER+
TCGTGCTTCCTTAGGG-1	LC_ER+
TCGTTAAAGCCGCAGT-1	LC_ER+
TCGTTAAAGGCCGGAA-1	LC_ER+
TCGTTACGTACTGATG-1	LC_ER+
TCGTTACGTGAGCAAG-1	LC_ER-
TCGTTAGCAATAATGG-1	LC_ER+
TCGTTAGCACTAGCGT-1	LC_ER-
TCGTTATTCCAGGTCA-1	LC_ER-
TCGTTATTCTTTGACT-1	LC_ER+
TCGTTTCCAAGGGTTG-1	LC_ER-
TCGTTTCCACACTAAT-1	Prolif
TCGTTTCCAGTTTGTG-1	LC_ER-
TCGTTTCCATTGCGTA-1	LC_ER-
TCTAACCGTAGACAAA-1	LC_ER+
TCTAACCGTCAATGTG-1	LC_ER+
TCTAACCGTCATCCTG-1	LC_ER+
TCTAACCGTCATGAGC-1	LC_ER+
TCTAACCGTTTGAGCA-1	LC_ER-
TCTAACTTCCATTACT-1	LC_ER+
TCTAACTTCCGGTTAG-1	LC_ER+
TCTAACTTCTCAATTC-1	LC_ER-
TCTAAGGGTACCGAAC-1	LC_ER+
TCTAAGGGTGTCACGG-1	LC_ER+
TCTAAGGGTTATTGCC-1	LC_ER-
TCTAATCTCCTTAGGG-1	LC_ER-
TCTAATCTCGTGCCTT-1	Immature_BC
TCTACCTCACTTAGGC-1	LC_ER+
TCTACTAGTCATTGTC-1	Immature_BC
TCTACTAGTGCAATGC-1	LC_ER+
TCTACTAGTGTGAGGA-1	LC_ER-
TCTACTAGTTAGGACC-1	LC_ER+
TCTACTAGTTTGCGAA-1	Immature_BC
TCTAGCACAAGTGTTT-1	LC_ER+
TCTAGCCTCCACCTTA-1	LC_ER+
TCTAGCCTCCCTGATC-1	LC_ER+
TCTAGCCTCCTGAGTG-1	LC_ER+
TCTAGCCTCGCATCCT-1	LC_ER-
TCTAGCCTCGTGCTAG-1	Immature_BC
TCTAGCGAGCCTGACA-1	LC_ER+
TCTAGCGAGGTTTACA-1	LC_ER+
TCTAGCGAGTGAGCGG-1	LC_ER-
TCTATGTTCAGCATTA-1	LC_ER+
TCTATGTTCCCTTGCG-1	Immature_BC
TCTATGTTCGAAGCGG-1	LC_ER+
TCTCAAGCACAGAACG-1	LC_ER-
TCTCAAGCATCATGGC-1	LC_ER-
TCTCAATTCCAAGTTA-1	LC_ER-
TCTCACCAGGGTCTAT-1	LC_ER-
TCTCACCAGTAAGGGC-1	HY_BC_ER+
TCTCCTCGTATTCGTC-1	LC_ER+
TCTCCTCGTTGGCCGA-1	LC_ER+
TCTCGCCCAATAACCT-1	LC_ER+
TCTCGCCCACCTATAG-1	LC_ER+
TCTCGCCCACCTCAGG-1	LC_ER-
TCTCGCCCAGCTCATA-1	LC_ER-
TCTCGCCCAGGAACTG-1	LC_ER+
TCTCGCCCATATTGAC-1	LC_ER+
TCTCGCCCATTGTCAG-1	Immature_BC
TCTGGCTTCAGGGCCT-1	LC_ER-
TCTGGCTTCCATAATG-1	LC_ER+
TCTGGCTTCGTGCTAG-1	LC_ER-
TCTGTGACACCTGGTG-1	LC_ER-
TCTGTGACAGGTTAAA-1	Immature_BC
TCTGTGACATAAGTTC-1	LC_ER+
TCTGTGACATCTTGAG-1	LC_ER+
TCTGTGACATGAATCT-1	LC_ER+
TCTTAGCGTACCGGAT-1	LC_ER+
TCTTAGCGTGCATCGG-1	LC_ER+
TCTTAGCGTGCTGTAA-1	Immature_BC
TCTTAGCGTTAGTTGG-1	LC_ER+
TCTTAGTTCATGGTTA-1	LC_ER-
TCTTAGTTCCGCAACA-1	LC_ER+
TCTTAGTTCGTGCTAG-1	LC_ER-
TCTTCAAGTCTATCGT-1	HY_ER+_ER-
TCTTCAAGTGAGGTAG-1	LC_ER+
TCTTGACGTTGCGCGA-1	LC_ER+
TCTTGTCCAACATAAG-1	LC_ER+
TCTTTGTAGAAGCTAG-1	LC_ER+
TCTTTGTAGCATGACT-1	Immature_BC
TCTTTGTAGGCATGTT-1	LC_ER-
TCTTTGTAGTCAGTAC-1	LC_ER-
TGAAACTGTAAAGCAA-1	LC_ER+
TGAAACTGTCAAGACC-1	LC_ER+
TGAAACTGTCCTAATC-1	Immature_BC
TGAAACTGTGCATTAG-1	LC_ER+
TGAAACTGTGGAGCAA-1	LC_ER-
TGAAACTGTGGATGTC-1	LC_ER+
TGAAACTGTGTTGCAA-1	LC_ER-
TGAAACTGTGTTGTAG-1	LC_ER+
TGAACAACACCAAAGG-1	LC_ER-
TGAACAACAGGACCAA-1	Immature_BC
TGAACAGAGACAACAG-1	LC_ER+
TGAACAGAGCATGCAT-1	LC_ER+
TGAACAGAGCCACATG-1	Immature_BC
TGAACAGAGCGAGCGA-1	LC_ER+
TGAAGCAAGCAAGGAC-1	LC_ER-
TGAAGCAAGCCGGTAC-1	LC_ER+
TGAAGCAAGCTTACTT-1	LC_ER-
TGAAGCAAGGTGAAAT-1	LC_ER-
TGAAGGATCAATCTCT-1	LC_ER-
TGAAGGATCACGTTAA-1	LC_ER+
TGAAGGATCCTGTTCA-1	LC_ER+
TGAAGGATCGCTTCTA-1	Immature_BC
TGAAGGATCTTGTCTG-1	LC_ER-
TGAAGTGAGCATTATG-1	Immature_BC
TGAAGTGAGCCTGGTA-1	LC_ER+
TGAAGTGAGCGGATAA-1	LC_ER-
TGAAGTGAGGGACCTC-1	LC_ER-
TGACCAAGTATTGGTG-1	LC_ER-
TGACCAAGTCAAGTAT-1	LC_ER-
TGACCAAGTCCTAAGA-1	LC_ER-
TGACCAAGTGACATGC-1	LC_ER+
TGACCAAGTTATCCGT-1	LC_ER+
TGACCAAGTTCCTCCT-1	Immature_BC
TGACCAAGTTCGCGCT-1	LC_ER+
TGACCAAGTTCGGGAT-1	LC_ER-
TGACCTTGTAAGCTTG-1	LC_ER+
TGACCTTGTGAATCGC-1	Immature_BC
TGACCTTGTTACCTGT-1	LC_ER+
TGACCTTGTTACTTCA-1	LC_ER-
TGACTCCTCTAAGGTC-1	Immature_BC
TGACTCCTCTCACTAT-1	LC_ER+
TGACTTAAGCTCAATA-1	LC_ER+
TGACTTAAGGACCGCT-1	LC_ER+
TGACTTAAGGCTAATC-1	LC_ER+
TGACTTCGTAGCCTCC-1	LC_ER+
TGACTTCGTGCGCGTA-1	LC_ER-
TGACTTCGTGTCCAAA-1	LC_ER+
TGACTTCGTTGAGCCG-1	LC_ER-
TGACTTCGTTTCCTCC-1	LC_ER+
TGAGAACCAACAGCCT-1	LC_ER-
TGAGAACCAGCGCTTG-1	LC_ER+
TGAGAACCATCCAGGT-1	LC_ER-
TGAGAACCATTAGCGC-1	LC_ER+
TGAGCAAAGCATGTCG-1	LC_ER-
TGAGCAAAGCGATACT-1	LC_ER-
TGAGCACGTCATTAGG-1	LC_ER-
TGAGCCGGTAAAGCGG-1	LC_ER+
TGAGCCGGTTATCCGT-1	Immature_BC
TGAGCTTAGAGGAGGA-1	HY_ER+_ER-
TGAGCTTAGCCTAATA-1	LC_ER-
TGAGCTTAGCTCATAA-1	Immature_BC
TGAGCTTAGGAATAAC-1	LC_ER+
TGAGCTTAGGCGAAAC-1	Immature_BC
TGAGCTTAGTCAATTG-1	LC_ER+
TGAGCTTAGTGAGAGC-1	LC_ER+
TGAGGAGGTGCTGTAA-1	LC_ER-
TGAGGAGGTGGATTAT-1	LC_ER-
TGAGGAGGTTGGTTCT-1	LC_ER-
TGAGGAGGTTTGCAGA-1	LC_ER-
TGAGGCACAACCTAAT-1	LC_ER-
TGAGGCACAAGGACCA-1	Immature_BC
TGAGGCACAAGGTACG-1	Immature_BC
TGAGGCACAATATAGG-1	LC_ER+
TGAGGCACAGTTTCTC-1	LC_ER+
TGAGGGAGTAGGATCC-1	LC_ER-
TGAGGGAGTCGCATAA-1	HY_ER+_ER-
TGAGGGAGTGGCTTCC-1	LC_ER-
TGAGGGCCATTGCGTA-1	LC_ER+
TGAGGTGCAAAGCGGC-1	LC_ER-
TGAGGTGCAGTTTACG-1	LC_ER+
TGAGTGAAGCCTAACG-1	LC_ER-
TGAGTGAAGCTCAAAC-1	LC_ER+
TGAGTGAAGGGATTAG-1	Immature_BC
TGAGTGAAGGTCCTGA-1	LC_ER-
TGAGTTTCATGAATAG-1	LC_ER-
TGATCAATCAATGACC-1	Immature_BC
TGATCAATCACAGCGC-1	LC_ER+
TGATCAATCAGGGCCT-1	LC_ER-
TGATCAATCATCACTT-1	LC_ER-
TGATCAATCCCGCAAA-1	LC_ER-
TGATCAATCCCGTTAC-1	LC_ER+
TGATCAATCGTTACTT-1	Immature_BC
TGATCACAGACTCGCA-1	LC_ER-
TGATCACAGCCGCTAA-1	LC_ER-
TGATCACAGTAAGTGG-1	HY_ER+_ER-
TGATCAGGTGCTCCGT-1	LC_ER-
TGATCAGGTTGGCCGA-1	Immature_BC
TGATCGAGTAATCCCT-1	LC_ER+
TGATCGAGTATTGGAT-1	LC_ER-
TGATCGAGTCCTTCAG-1	LC_ER-
TGATCGAGTGGATTGC-1	LC_ER+
TGATGAACAATCCTGA-1	LC_ER+
TGATGAACAGATTCAT-1	LC_ER+
TGATGAACAGCAATAA-1	LC_ER-
TGATGACTCCTGGTGA-1	LC_ER-
TGATGACTCGCAACAT-1	LC_ER-
TGATGACTCGTTTCGC-1	LC_ER+
TGATGATGTAACGGGA-1	LC_ER+
TGATGATGTCCAAGAC-1	LC_ER+
TGATGATGTCCTTTAA-1	LC_ER+
TGATGATGTGTCCAGG-1	LC_ER-
TGATGATGTTGTTGCT-1	LC_ER+
TGATGATGTTTGGCGG-1	LC_ER-
TGATTAGTCATTGTTC-1	LC_ER-
TGATTCAAGGCGGATG-1	LC_ER+
TGATTCAAGGCGGGTA-1	LC_ER+
TGATTCAAGTTAGAGG-1	LC_ER+
TGATTCAAGTTTCCGC-1	LC_ER+
TGATTGCAGCTATGAC-1	LC_ER-
TGCAAGCGTACCGTTT-1	Prolif
TGCAAGCGTATTTGGG-1	LC_ER-
TGCAAGCGTCACAGCG-1	LC_ER+
TGCAAGCGTTCATTTG-1	LC_ER-
TGCAATATCATGTCAA-1	Immature_BC
TGCAATATCATTGCGG-1	Immature_BC
TGCAATATCCTTGCGT-1	LC_ER+
TGCAATATCGTTAGCG-1	LC_ER+
TGCAATATCTGTTGCC-1	Immature_BC
TGCAATATCTTTGTAC-1	HY_ER+_ER-
TGCACACCACCAGGTT-1	LC_ER+
TGCACACCACCATATG-1	LC_ER+
TGCACACCATTGCGGT-1	LC_ER-
TGCACCTTCAAGGACA-1	HY_ER+_ER-
TGCACCTTCATAGACC-1	LC_ER+
TGCACCTTCCTGAATA-1	LC_ER+
TGCACCTTCTACTAAG-1	LC_ER-
TGCACCTTCTCCATAT-1	HY_ER+_ER-
TGCACCTTCTTAGGAC-1	LC_ER-
TGCACTTGTCCTAATC-1	HY_ER+_ER-
TGCACTTGTTATGTGG-1	LC_ER+
TGCAGGCTCATCCTAT-1	LC_ER-
TGCAGGCTCCGGTTAG-1	LC_ER-
TGCAGGCTCCTTTACG-1	LC_ER+
TGCATCCTCAGCACGC-1	LC_ER+
TGCATCCTCCTAGTAA-1	LC_ER+
TGCATCCTCTGTTCAT-1	LC_ER+
TGCATGAGTAGTCAAT-1	LC_ER+
TGCATGAGTTTCGCCA-1	Immature_BC
TGCATTAAGTGAGGGT-1	LC_ER+
TGCATTAAGTGTTGCG-1	LC_ER+
TGCATTAAGTTGTCCC-1	Immature_BC
TGCATTAAGTTTCCTG-1	LC_ER-
TGCCATTGTGGACCTG-1	Immature_BC
TGCCATTGTTAAGCCA-1	LC_ER-
TGCCGGTAGCTGCACA-1	LC_ER-
TGCCGGTAGCTGTACG-1	LC_ER+
TGCCGGTAGGCATGAA-1	LC_ER+
TGCCGGTAGTCAGTAC-1	LC_ER+
TGCCTGTTCATTAGCA-1	LC_ER+
TGCGATTAGCTAGAAG-1	HY_ER+_ER-
TGCGATTAGGTTTACA-1	LC_ER+
TGCGCAGGTAACCACA-1	LC_ER+
TGCGCAGGTAGCCATA-1	LC_ER+
TGCGCAGGTGATTTGG-1	LC_ER+
TGCGCAGGTTGTGATG-1	LC_ER+
TGCGGTTCAAAGCTAA-1	LC_ER+
TGCGGTTCATCACAGC-1	LC_ER-
TGCGGTTCATGTTTGG-1	LC_ER-
TGCTAACAGCATTATG-1	LC_ER+
TGCTAACAGGATTGCT-1	Immature_BC
TGCTAACAGGGTGGAT-1	LC_ER+
TGCTAGCCATGTTTGG-1	Immature_BC
TGCTATGCACGAATTT-1	LC_ER-
TGCTCAACAAACTGTT-1	LC_ER-
TGCTCAACAACTAGGG-1	LC_ER+
TGCTCAACACACCAAC-1	LC_ER+
TGCTCAACACCAGCAT-1	LC_ER+
TGCTCAACAGAAATTG-1	LC_ER+
TGCTCAACAGTGAACG-1	LC_ER+
TGCTCAACATTGTGAT-1	Immature_BC
TGCTCACTCCCTTGCG-1	LC_ER-
TGCTCCGTCCCGTTAC-1	LC_ER+
TGCTCCGTCGGTACGC-1	LC_ER+
TGCTCTCAGGAACCGG-1	HY_BC_ER+
TGCTCTCAGGACAATG-1	Immature_BC
TGCTCTCAGGCGGATG-1	LC_ER-
TGCTCTCAGGGATGCG-1	LC_ER+
TGCTCTCAGTCATTTC-1	LC_ER-
TGCTCTCAGTTATTCC-1	Immature_BC
TGCTGGATCAACAAGG-1	LC_ER-
TGCTGGATCTGGTCCT-1	Immature_BC
TGCTGGATCTGTAAGC-1	LC_ER-
TGCTGGATCTTCAATC-1	LC_ER+
TGCTTAAAGTATCGCG-1	LC_ER-
TGCTTCATCAAGTGAG-1	LC_ER-
TGCTTCATCAGCAAGA-1	LC_ER-
TGCTTCATCATTCATC-1	LC_ER-
TGCTTCATCATTTGTC-1	LC_ER+
TGCTTCATCGCGACAC-1	LC_ER-
TGCTTCATCGCTCCAT-1	LC_ER-
TGCTTCCAGCTATATG-1	LC_ER+
TGCTTGCTCAAAGGCA-1	LC_ER-
TGCTTGCTCACCGGTA-1	LC_ER+
TGCTTGCTCAGTATTG-1	LC_ER+
TGCTTGCTCATGCAAC-1	LC_ER+
TGCTTGTGTAAGCTCA-1	LC_ER+
TGCTTGTGTAATTAGC-1	LC_ER+
TGCTTTAGTCGCGCAA-1	HY_ER+_ER-
TGCTTTAGTGTGTCCC-1	LC_ER+
TGCTTTAGTTAACGAT-1	LC_ER+
TGGAACAAGCGAGTAA-1	LC_ER+
TGGAACAAGGAGTCGG-1	LC_ER+
TGGACAAAGTTAGACC-1	Immature_BC
TGGACAAAGTTTGGGT-1	LC_ER+
TGGACCGGTGACATGC-1	HY_ER+_ER-
TGGACCGGTTCCAGGG-1	LC_ER+
TGGACCGGTTGTTGCT-1	LC_ER+
TGGACTAGTCTTTGAC-1	LC_ER+
TGGATTCAGACCATAC-1	LC_ER+
TGGATTCAGATGGAGC-1	LC_ER-
TGGATTCAGCTTCTCA-1	Immature_BC
TGGATTCAGGACCTGC-1	LC_ER+
TGGATTCAGGCTAAGA-1	LC_ER-
TGGATTCAGGTCGAGG-1	LC_ER-
TGGATTGGTAATTAGC-1	LC_ER-
TGGATTGGTTGAGCCG-1	HY_ER+_ER-
TGGATTGGTTGTAACG-1	LC_ER-
TGGCCAATCCCTCAAC-1	HY_ER+_ER-
TGGCCAATCGTTAGCG-1	LC_ER+
TGGCCATCAAACGGGC-1	LC_ER+
TGGCCATCACAAGCCT-1	LC_ER-
TGGCCATCACCAAAGG-1	HY_ER+_ER-
TGGCCATCACGAACAG-1	Immature_BC
TGGCCATCAGTCTAGC-1	LC_ER+
TGGCCTGCAAACTGTT-1	LC_ER-
TGGCCTGCAATCCCTT-1	LC_ER+
TGGCCTGCATATAACC-1	LC_ER-
TGGCGGTTCAATGTCA-1	HY_ER+_ER-
TGGCGGTTCACTAAGC-1	LC_ER-
TGGCGGTTCACTCGCT-1	Immature_BC
TGGCGGTTCCAACTGG-1	LC_ER+
TGGCGGTTCCCGCATT-1	LC_ER+
TGGCGGTTCGGCCATA-1	LC_ER+
TGGCTAAGTGAACAAA-1	HY_ER+_ER-
TGGCTAAGTGAGCAAG-1	LC_ER+
TGGCTAAGTTAGGTTG-1	LC_ER-
TGGCTAAGTTTGCGAA-1	LC_ER+
TGGCTATAGCATTAGC-1	HY_ER+_ER-
TGGCTATAGCATTTCT-1	LC_ER+
TGGCTATAGGACAACA-1	LC_ER-
TGGCTATAGGATCCGC-1	LC_ER+
TGGCTTTGTCATTGTC-1	LC_ER-
TGGCTTTGTGTTTGTC-1	LC_ER+
TGGGCATGTAACCAGC-1	HY_ER+_ER-
TGGGCATGTAGGTTTG-1	LC_ER-
TGGGCATGTCATGAGC-1	LC_ER+
TGGGCATGTCTAGCTT-1	LC_ER-
TGGGCATGTTATGTGG-1	Immature_BC
TGGGCCTAGCAAGGAC-1	LC_ER+
TGGGCCTAGCCTGTTC-1	LC_ER+
TGGGCCTAGGACCTTG-1	LC_ER-
TGGGCCTAGTAAAGGT-1	LC_ER+
TGGGCCTAGTCACTCC-1	LC_ER+
TGGTAAACAATGAGGT-1	Immature_BC
TGGTAAACACAATGCC-1	LC_ER+
TGGTAAACACCAGCAT-1	HY_BC_ER+
TGGTAAACATGGCCCA-1	LC_ER+
TGGTCAAGTCCTAGTT-1	LC_ER-
TGGTCAAGTGAGCAAG-1	LC_ER-
TGGTCAAGTGATCAGC-1	LC_ER+
TGGTCAAGTGTTTCAC-1	Immature_BC
TGGTCAAGTTACGCAA-1	HY_ER+_ER-
TGGTCAAGTTGCATCT-1	LC_ER+
TGGTCATAGAGGAAGG-1	Immature_BC
TGGTCATAGGTAACGA-1	Immature_BC
TGGTCATAGGTTTGCG-1	LC_ER+
TGGTCATAGTAACAGG-1	LC_ER-
TGGTCATAGTGGCGGA-1	Immature_BC
TGGTGATTCAAGCCTG-1	LC_ER-
TGGTGATTCACAGCGC-1	LC_ER-
TGGTGATTCCCATAGG-1	LC_ER+
TGGTGATTCGTTTCTG-1	LC_ER+
TGGTGATTCTCCTCTT-1	Immature_BC
TGGTGCATCATGACCG-1	LC_ER+
TGGTGCATCGACAAAG-1	LC_ER-
TGGTGCATCGTTTCTG-1	LC_ER-
TGGTTAATCCAATTAG-1	LC_ER+
TGGTTAATCCGTGACA-1	HY_ER+_ER-
TGGTTAATCGCACACA-1	LC_ER-
TGGTTAATCGGTCAAT-1	LC_ER-
TGGTTAATCGGTTTGG-1	LC_ER+
TGGTTAATCTTTGACT-1	Immature_BC
TGGTTCCTCGAGGTGG-1	Immature_BC
TGGTTCCTCTTTAAGG-1	LC_ER-
TGGTTCTGTAATAGCT-1	LC_ER-
TGGTTCTGTACCTTAC-1	LC_ER+
TGGTTCTGTGCGCAAT-1	LC_ER+
TGGTTCTGTGGACATC-1	LC_ER-
TGGTTGAGTGCTAGCG-1	LC_ER+
TGTAAAGCAAGGACCA-1	LC_ER-
TGTAAAGCAGGCCAAA-1	LC_ER+
TGTAAAGCAGGTTAAA-1	LC_ER-
TGTAAAGCAGTTGCGT-1	LC_ER+
TGTAAAGCATTAAGTC-1	HY_ER+_ER-
TGTAAAGCATTGTCAG-1	LC_ER+
TGTAACTCAGGCCATT-1	LC_ER+
TGTAAGCTCAATCTCT-1	LC_ER+
TGTAAGCTCTAAGTCA-1	Prolif
TGTAAGCTCTTGAGCG-1	LC_ER+
TGTAAGTGTAATGACT-1	LC_ER+
TGTAAGTGTGCTCACC-1	HY_BC_ER+
TGTAAGTGTTAGACCA-1	HY_ER+_ER-
TGTAAGTGTTGTGACA-1	LC_ER+
TGTAAGTGTTTGAGGC-1	LC_ER-
TGTAATGTCGCAACAT-1	LC_ER-
TGTATCCGTAGTTGGC-1	LC_ER+
TGTATCCGTCATGCAA-1	LC_ER+
TGTATCGCAATTGAGA-1	LC_ER+
TGTATCGCACCTGCTC-1	LC_ER+
TGTCAATCAAATGCCC-1	LC_ER+
TGTCAATCAGCACGTT-1	LC_ER-
TGTCAATCAGGAACTG-1	LC_ER-
TGTCAATCAGGATGGC-1	LC_ER-
TGTCAGTAGCTTCTCA-1	LC_ER-
TGTCAGTAGGAGGTTA-1	LC_ER+
TGTCAGTAGTTACCGG-1	Immature_BC
TGTCAGTAGTTACTTC-1	HY_ER+_ER-
TGTCAGTAGTTTCCGC-1	LC_ER-
TGTCAGTAGTTTGAGC-1	LC_ER-
TGTCATAAGACAGGTA-1	LC_ER+
TGTCATAAGAGCCGCT-1	LC_ER+
TGTCATAAGAGGAAGG-1	Immature_BC
TGTCATAAGCACAGCC-1	Prolif
TGTCATAAGGAGCAAC-1	Immature_BC
TGTCATAAGGAGTCTT-1	LC_ER-
TGTCATAAGTATTGCA-1	LC_ER+
TGTCATAAGTCAATTG-1	LC_ER-
TGTCCTGGTCGCGCAA-1	LC_ER+
TGTCCTGGTGAGCACT-1	LC_ER-
TGTCCTTCAAAGCCTC-1	Immature_BC
TGTCCTTCATGTTGGC-1	HY_ER+_ER-
TGTCCTTCATGTTTGG-1	LC_ER+
TGTGAAACAAAGGTAC-1	LC_ER-
TGTGAAACAAGGTACG-1	LC_ER-
TGTGAAACAGCAACAG-1	Immature_BC
TGTGAAACAGCAACCT-1	LC_ER+
TGTGAAACATTGTGGC-1	LC_ER-
TGTGATCAGCAAGACA-1	LC_ER-
TGTGATCAGCCGCAGT-1	LC_ER-
TGTGATCAGCCTGACA-1	Immature_BC
TGTGATCAGGGACTAA-1	LC_ER-
TGTGATCAGGTTAGAG-1	LC_ER+
TGTGATCAGTGAGGGT-1	LC_ER+
TGTGATCAGTTGTCCC-1	LC_ER-
TGTGCAAGTGATGAGG-1	LC_ER-
TGTGCAAGTTCATTTG-1	LC_ER-
TGTGCACCATAGCTTG-1	LC_ER+
TGTGCACCATGAGCAG-1	LC_ER+
TGTGCACCATTAGGCC-1	LC_ER+
TGTGCGCAGCTGTAAC-1	Immature_BC
TGTGCGCAGCTGTCAG-1	LC_ER+
TGTGCGGGTCAAACTG-1	LC_ER+
TGTGCTGAGCTCCCTG-1	LC_ER+
TGTGCTGAGGTCCACA-1	LC_ER+
TGTGCTGAGTAACAGG-1	LC_ER-
TGTGCTGAGTAGCGCC-1	LC_ER-
TGTGCTGAGTTAGACC-1	LC_ER+
TGTGCTGAGTTTAACG-1	LC_ER+
TGTGGAGCAATGCGCT-1	LC_ER-
TGTGGAGCAGGCGAGT-1	LC_ER+
TGTGGAGCAGTAGGTG-1	LC_ER-
TGTGGCCAGCCGCTTT-1	LC_ER+
TGTGGCCAGTCAATTG-1	LC_ER+
TGTGGCCAGTTCCTCA-1	LC_ER+
TGTGGCGGTCAGGCCA-1	Immature_BC
TGTGGCGGTGAATCGC-1	LC_ER+
TGTGGCGGTTTATGGG-1	LC_ER+
TGTGTGAGTACTGATG-1	LC_ER-
TGTGTGAGTTTGCAGA-1	LC_ER+
TGTGTTAAGTAAGGGC-1	HY_ER+_ER-
TGTGTTAAGTTGGGCC-1	LC_ER+
TGTTACTTCACATTGA-1	LC_ER-
TGTTACTTCATGCTTT-1	LC_ER+
TGTTACTTCCCGCCTA-1	LC_ER+
TGTTACTTCGCACACA-1	LC_ER+
TGTTACTTCGGCCATA-1	Immature_BC
TGTTACTTCGTAATCA-1	LC_ER-
TGTTACTTCGTGCCTT-1	LC_ER-
TGTTAGCAGACAAACG-1	HY_ER+_ER-
TGTTAGCAGCTGCACA-1	LC_ER+
TGTTAGCAGGGACGCA-1	LC_ER+
TGTTAGCAGTAAGAAC-1	LC_ER-
TGTTAGCAGTCACGAT-1	LC_ER+
TGTTCATTCATGTTTC-1	LC_ER+
TGTTCATTCCCGTTGT-1	LC_ER+
TGTTCATTCTCAATTC-1	HY_ER+_ER-
TGTTCATTCTTAAGTG-1	HY_ER+_ER-
TGTTCATTCTTAGTGA-1	LC_ER+
TGTTCCTCAGATTCAT-1	LC_ER+
TGTTCCTCAGCGCTTG-1	LC_ER+
TGTTCCTCATTAAGCT-1	LC_ER+
TGTTGCACATGTTGCA-1	LC_ER-
TGTTGGCCAATAACCT-1	LC_ER+
TGTTGGCCAGGACCAA-1	LC_ER-
TGTTGGCCAGGCATGA-1	LC_ER-
TGTTGGCCAGTAAAGC-1	LC_ER+
TGTTGGCCATAATCCG-1	LC_ER-
TGTTGTAAGCATGAAG-1	Immature_BC
TGTTGTAAGGACCTCA-1	LC_ER+
TGTTGTGCAATAGCCC-1	LC_ER-
TGTTGTGCACGTAATT-1	LC_ER+
TGTTGTGCACTTGTTC-1	Immature_BC
TGTTGTGCAGCTTAAT-1	LC_ER-
TGTTGTGCATCAATCG-1	LC_ER-
TGTTGTTTCCGCTAGA-1	LC_ER-
TGTTGTTTCGAAGTGA-1	HY_ER+_ER-
TGTTGTTTCTGTGCCT-1	LC_ER-
TGTTTGTTCATTACAG-1	LC_ER+
TTAAAGGCAAATACCT-1	LC_ER-
TTAAAGGCAATGAGGT-1	LC_ER+
TTAAAGGCACGGTACT-1	Immature_BC
TTAAAGGCACTAAGCC-1	LC_ER+
TTAAAGGCAGATAGAC-1	Immature_BC
TTAACCAAGCATCCAG-1	Immature_BC
TTAACCAAGCATGGTT-1	LC_ER+
TTAACCAAGCCTGGTA-1	LC_ER+
TTAACCAAGCTAATTG-1	LC_ER-
TTAACCAAGGAATAAC-1	LC_ER-
TTAACCAAGGAGTCTT-1	Immature_BC
TTAACCAAGGGTTATC-1	HY_BC_ER+
TTAACCAAGTGCTGTG-1	LC_ER-
TTAACCAAGTTGTCCC-1	Immature_BC
TTAACTGAGCCAGTAT-1	HY_ER+_ER-
TTAACTGAGCTGGAAA-1	LC_ER+
TTAACTGAGGAACGGT-1	LC_ER-
TTAACTGAGGTCCGTA-1	LC_ER-
TTAAGCCAGCGAGCGA-1	Immature_BC
TTAAGCCAGCGGATTT-1	LC_ER-
TTAAGCCAGGAAGTAT-1	HY_ER+_ER-
TTAAGCCAGGATGATG-1	LC_ER+
TTAAGCCAGTTTGAGC-1	Immature_BC
TTAAGGACAATGAATG-1	LC_ER-
TTAAGGACATCCTAGA-1	LC_ER-
TTAAGGACATGCAACC-1	Immature_BC
TTAAGGACATGCATAT-1	LC_ER-
TTAAGGTGTGTTGTGA-1	LC_ER-
TTAAGGTGTTGCCTCA-1	LC_ER-
TTAAGTGTCCACCCTG-1	Immature_BC
TTAAGTGTCCCGTTAC-1	LC_ER+
TTAAGTGTCTTGCTAT-1	LC_ER-
TTAATCGAGCGAGTAA-1	LC_ER+
TTAATCGAGGTCCGTA-1	LC_ER-
TTACAGCAGCTGAGGG-1	LC_ER-
TTACAGCAGCTTGCTC-1	LC_ER+
TTACAGCAGGAGCAAC-1	LC_ER+
TTACAGCAGGCGGATG-1	LC_ER+
TTACAGCAGGGACTAA-1	Immature_BC
TTACAGCAGGGATGAC-1	LC_ER-
TTACAGCAGGTGAAGC-1	LC_ER-
TTACAGCAGTCCTGAG-1	Immature_BC
TTACAGCAGTTATGGC-1	LC_ER+
TTACAGCAGTTATTCC-1	LC_ER-
TTACCGTGTCCTAATC-1	LC_ER+
TTACCGTGTCGAAGTC-1	LC_ER-
TTACCGTGTTAGCAGC-1	LC_ER+
TTACCTGTCCGCATGA-1	LC_ER+
TTACCTGTCGATTCTT-1	LC_ER+
TTACCTGTCTAATCAG-1	LC_ER+
TTACGTTTCCTCCCTC-1	LC_ER-
TTACGTTTCCTCCTAA-1	LC_ER-
TTACGTTTCGTTAAGC-1	LC_ER+
TTACGTTTCTAATTGG-1	LC_ER-
TTAGAAGCAGTAGGTG-1	LC_ER+
TTAGAAGCATACCCGG-1	Immature_BC
TTAGACTCACCCACAG-1	LC_ER+
TTAGACTCACCCTCAC-1	LC_ER-
TTAGACTCATCCTAGA-1	LC_ER+
TTAGCAATCAGGAAGC-1	LC_ER+
TTAGCAATCCTCATCA-1	LC_ER-
TTAGCAGGTACCAGGT-1	LC_ER+
TTAGCAGGTATTGAGT-1	LC_ER+
TTAGCAGGTGACATAT-1	LC_ER-
TTAGCAGGTGGGAACA-1	LC_ER+
TTAGCAGGTGTGAGAG-1	LC_ER+
TTAGCAGGTTAGGTTG-1	LC_ER-
TTAGCAGGTTGTTGCT-1	LC_ER-
TTAGCAGGTTTACCGT-1	HY_ER+_ER-
TTAGCCTGTATTTGCC-1	LC_ER-
TTAGCCTGTCTCAGCC-1	Immature_BC
TTAGCCTGTGCAATGC-1	LC_ER-
TTAGCCTGTTATCCTA-1	LC_ER+
TTAGCCTGTTGCAATG-1	LC_ER+
TTAGCCTGTTTCGCCA-1	LC_ER+
TTAGCGGTCCAGGAAA-1	LC_ER-
TTAGCGGTCCAGGTCA-1	LC_ER-
TTAGCGGTCCCGCATT-1	Immature_BC
TTAGCGGTCCTAATTC-1	LC_ER-
TTAGCTGCAGGAACAT-1	Immature_BC
TTAGGAACAAATATCC-1	LC_ER+
TTAGGAACAGCATGGA-1	LC_ER+
TTAGGCCCAGTACCGT-1	LC_ER-
TTAGGCCCATATTGAC-1	HY_BC_ER+
TTAGGCGTCAATGACC-1	LC_ER+
TTAGGCGTCATGGTGT-1	LC_ER+
TTAGGCTAGGAAGCAC-1	LC_ER+
TTAGTCAAGCAAGACA-1	HY_ER+_ER-
TTAGTCAAGTATCGCG-1	HY_ER+_ER-
TTAGTCAAGTTATGGC-1	LC_ER+
TTATAGCCACAACAGG-1	LC_ER+
TTATAGCCACCTCGCT-1	LC_ER+
TTATAGCCACGTAATT-1	Immature_BC
TTATCCGTCACGCGGT-1	Prolif
TTATCCGTCATTAGGC-1	Immature_BC
TTATCCGTCGATTTGA-1	LC_ER+
TTATCCTAGAGAAGGG-1	LC_ER+
TTATGACCAAGTAAGC-1	LC_ER+
TTATGACCAATTATGC-1	HY_ER+_ER-
TTATGACCAGCAAGGC-1	HY_ER+_ER-
TTATGACCATCACTTC-1	LC_ER-
TTATGACCATTAGCCA-1	Immature_BC
TTATGCGCAGAAATTG-1	LC_ER+
TTATGCGCAGCCGCTA-1	LC_ER+
TTATGCGCATTAAACC-1	LC_ER+
TTATGCGCATTATGAC-1	Immature_BC
TTATTGCTCATGCTAA-1	LC_ER+
TTATTGCTCGCGACAC-1	LC_ER-
TTATTGCTCGGGATTT-1	LC_ER+
TTATTGCTCTAATTGG-1	LC_ER+
TTATTGCTCTGGCAAT-1	LC_ER-
TTCAACCGTCACACCC-1	LC_ER+
TTCAACCGTTGTTCAC-1	LC_ER+
TTCAACCGTTTAGCTC-1	LC_ER+
TTCACTGTCCTTAGGG-1	LC_ER+
TTCACTGTCTAACTGA-1	LC_ER+
TTCACTGTCTGCAAGT-1	Immature_BC
TTCAGGTAGCGAGGTG-1	LC_ER-
TTCAGTTTCCACCTGT-1	LC_ER-
TTCAGTTTCCCGAACA-1	LC_ER+
TTCAGTTTCGCGCTAA-1	LC_ER+
TTCAGTTTCTTAGTCT-1	LC_ER+
TTCATCCCAATCATGT-1	HY_BC_ER+
TTCATCCCAATGCGCT-1	LC_ER-
TTCATCCCACTTAGGC-1	LC_ER-
TTCATCCCAGCCTGCA-1	LC_ER-
TTCATCCCATTAGCCA-1	HY_ER+_ER-
TTCATTCAGCAACATC-1	LC_ER-
TTCATTCAGGCCGGAA-1	Immature_BC
TTCATTCAGGCCTGGT-1	LC_ER+
TTCATTCAGGCTAATC-1	LC_ER-
TTCATTCAGTACTGGT-1	LC_ER-
TTCCACGGTAGCTAGC-1	Immature_BC
TTCCACGGTCCGTAGG-1	LC_ER+
TTCCACGGTCTCACTG-1	LC_ER+
TTCCCACAGCATTTCT-1	LC_ER+
TTCCCACAGGCAATAG-1	LC_ER+
TTCCCACAGGCCCAGT-1	LC_ER-
TTCCCACAGGCTACAT-1	LC_ER-
TTCCCACAGTCACTAA-1	LC_ER+
TTCCCGCCAAGATTCT-1	Immature_BC
TTCCCGCCACAAAGGT-1	LC_ER-
TTCCCGCCACCTACTT-1	LC_ER+
TTCCCGCCACCTCACC-1	LC_ER+
TTCCCGCCAGCTACGT-1	LC_ER+
TTCCCGCCAGCTTACA-1	LC_ER-
TTCCCGCCAGGTCCTG-1	LC_ER-
TTCCTCAAGTCACCAG-1	LC_ER-
TTCCTCAAGTCCTTCA-1	LC_ER-
TTCCTCAAGTGAAGTG-1	LC_ER-
TTCCTCAAGTTGTCCC-1	LC_ER+
TTCCTTCTCTATGACA-1	LC_ER-
TTCCTTGAGAGAAGGG-1	LC_ER+
TTCCTTGAGTTCCTGC-1	HY_ER+_ER-
TTCCTTGAGTTGGATC-1	LC_ER-
TTCCTTGAGTTGTCTT-1	LC_ER+
TTCGCAACAAGACTCC-1	LC_ER+
TTCGCAACACAGACTC-1	LC_ER-
TTCGCAACAGCATTAT-1	Immature_BC
TTCGGTACATCGTTCT-1	LC_ER-
TTCGGTACATGTCGCG-1	Prolif
TTCGTGCTCATCCTAT-1	Immature_BC
TTCGTGCTCATGCGTG-1	Immature_BC
TTCGTGCTCTACTAAG-1	LC_ER-
TTCGTTAGTGTAATAC-1	LC_ER+
TTCGTTAGTTTGCGCC-1	Immature_BC
TTCTTAGGTAAACAAG-1	LC_ER-
TTCTTAGGTAATGGCC-1	LC_ER-
TTCTTAGGTCAGGCCA-1	Immature_BC
TTCTTAGGTCTTGCAT-1	LC_ER+
TTCTTAGGTGTGCACG-1	LC_ER+
TTCTTAGGTTGGGTTA-1	LC_ER+
TTCTTAGGTTGTTGGA-1	LC_ER+
TTGACATCAAGTAAGC-1	LC_ER+
TTGACATCAGGCAAGC-1	Immature_BC
TTGACATCAGGCTAAG-1	LC_ER+
TTGACGTAGACACCGC-1	LC_ER+
TTGACGTAGAGAGGAG-1	LC_ER-
TTGACGTAGGTCCAAT-1	LC_ER+
TTGACGTAGGTCTTGG-1	LC_ER-
TTGACGTAGTGAACCT-1	Immature_BC
TTGACTAAGAGCCGCT-1	LC_ER+
TTGACTAAGAGGGACT-1	LC_ER-
TTGACTAAGTCATGCG-1	LC_ER+
TTGACTAAGTTCCCGT-1	LC_ER+
TTGAGCTAGGATAAAC-1	LC_ER-
TTGAGCTAGGATCACT-1	LC_ER+
TTGAGGCGTACCGTTT-1	LC_ER-
TTGAGGCGTCCACAAA-1	HY_ER+_ER-
TTGAGGCGTCCTAGTT-1	LC_ER-
TTGAGGCGTGATGAGG-1	HY_BC_ER+
TTGAGGCGTGGAAGGC-1	Immature_BC
TTGATGTCATAAGTCT-1	LC_ER+
TTGCAACAGAAAGGAA-1	LC_ER+
TTGCAACAGGCTAGAA-1	Immature_BC
TTGCAACAGTGAGCAA-1	LC_ER-
TTGCAACAGTTTCCGC-1	LC_ER+
TTGCAAGGTAATCGTG-1	LC_ER+
TTGCAAGGTGGATTCA-1	LC_ER+
TTGCAAGGTTTACGTC-1	LC_ER+
TTGCAATCACTGACCG-1	LC_ER+
TTGCAATCAGCATGGA-1	LC_ER+
TTGCAATCAGGCTGTT-1	LC_ER-
TTGCAATCATGCATAT-1	LC_ER-
TTGCAATCATTCAGCA-1	LC_ER-
TTGCACACAAATGCCC-1	LC_ER+
TTGCACACAATTGCGC-1	LC_ER-
TTGCACACAGCATGGA-1	Immature_BC
TTGCAGCCAATAGCAA-1	HY_ER+_ER-
TTGCAGCCAGCATTAT-1	LC_ER+
TTGCAGCCATGGCCTG-1	HY_ER+_ER-
TTGCATTTCCTCCATA-1	LC_ER+
TTGCATTTCTTGAGGT-1	LC_ER+
TTGCCCGTCACGTTAA-1	LC_ER-
TTGCCCGTCATAAGCC-1	LC_ER-
TTGCCCGTCCTTGAGG-1	LC_ER-
TTGCCCGTCGTAACGT-1	LC_ER-
TTGCGAGTCATTGCGG-1	Immature_BC
TTGCGTCTCTCACTAT-1	LC_ER+
TTGCTCTCACAGCCAT-1	LC_ER+
TTGCTCTCACCCACAG-1	HY_ER+_ER-
TTGCTCTCAGCATGTC-1	LC_ER-
TTGCTTAGTATTACCC-1	LC_ER-
TTGCTTAGTCAGGCCA-1	LC_ER-
TTGCTTAGTGTTCCCA-1	Immature_BC
TTGCTTAGTTGGATAT-1	LC_ER+
TTGCTTTAGAAGCTAG-1	LC_ER-
TTGCTTTAGCTGGAAA-1	LC_ER-
TTGCTTTAGGGACCTC-1	LC_ER-
TTGGAGGCAAATTGCT-1	Immature_BC
TTGGAGGCAATTTGGT-1	Immature_BC
TTGGAGGCATGCAACC-1	LC_ER-
TTGGATATCATGTCAA-1	LC_ER+
TTGGATATCCTCCTAA-1	LC_ER+
TTGGATCAGCATGCAT-1	LC_ER-
TTGGATCAGCCAGGTC-1	LC_ER-
TTGGATCAGCTGTCAG-1	HY_ER+_ER-
TTGGATCAGCTTGCTC-1	LC_ER+
TTGGATCAGGAGGCAT-1	LC_ER+
TTGGATCAGGTGAGAC-1	Immature_BC
TTGGATCAGGTTACGT-1	Immature_BC
TTGGATTCAAGATTCT-1	LC_ER-
TTGGATTCAAGCTACC-1	LC_ER-
TTGGATTCACCTCACC-1	LC_ER-
TTGGATTCAGGATGGC-1	Immature_BC
TTGGATTCATCACTTC-1	LC_ER-
TTGGCGGGTCATAACG-1	LC_ER-
TTGGCGGGTTAGACCA-1	Immature_BC
TTGGCGGGTTAGGTGC-1	LC_ER+
TTGGCTACACGTGCTG-1	Immature_BC
TTGGCTACATCCCTCA-1	Immature_BC
TTGGCTACATTTAAGC-1	LC_ER-
TTGGCTGAGCGGTTAT-1	LC_ER+
TTGGCTGAGGCGAAAC-1	LC_ER+
TTGGCTTGTCAAAGGG-1	LC_ER-
TTGGCTTGTGTAATAC-1	LC_ER+
TTGGCTTGTGTGAGGA-1	LC_ER-
TTGGCTTGTGTTTGCT-1	LC_ER-
TTGGCTTGTTAACAGT-1	LC_ER-
TTGGCTTGTTAGTGAT-1	Immature_BC
TTGGGCCAGAGAGGAG-1	LC_ER+
TTGGGCCAGCAAGATG-1	LC_ER-
TTGGGCCAGGAAGCTA-1	LC_ER+
TTGGGCCAGGACAACA-1	LC_ER+
TTGGGCCAGGACGTAA-1	Immature_BC
TTGGGCCAGGCCCAGT-1	LC_ER+
TTGGGCCAGGTGCGGA-1	LC_ER+
TTGGGCCAGTCATGCG-1	LC_ER-
TTGGGCGGTGGATGTC-1	LC_ER-
TTGGGCGGTTGCAGTA-1	LC_ER+
TTGGGCGGTTGTTCAC-1	LC_ER+
TTGGGTTAGCAAGATG-1	LC_ER+
TTGGTGAGTACGGTAC-1	HY_BC_ER+
TTGGTGAGTAGGTGTC-1	LC_ER-
TTGGTGAGTGTCCTGC-1	Immature_BC
TTGGTGAGTGTTGCTT-1	LC_ER+
TTGGTGAGTTGACTTC-1	LC_ER-
TTGTAAGTCACAAGCT-1	LC_ER-
TTGTAAGTCACTCGCT-1	LC_ER-
TTGTAAGTCGTTTCTG-1	LC_ER+
TTGTAAGTCTAGCGTG-1	LC_ER+
TTGTCAAAGCGCATTG-1	LC_ER+
TTGTCAAAGCTCATAA-1	LC_ER-
TTGTCAAAGGTTAGAG-1	LC_ER+
TTGTCAAAGTAGGATG-1	LC_ER-
TTGTCCATCCGGCTAA-1	Immature_BC
TTGTCCCAGACCATAC-1	LC_ER+
TTGTCCCAGCCTGTTC-1	LC_ER+
TTGTCCCAGGGCTTAT-1	LC_ER-
TTGTCCGGTATTCGTC-1	LC_ER+
TTGTCCGGTTTGGCTT-1	LC_ER-
TTGTGAGGTGCCTCAC-1	LC_ER-
TTGTGAGGTTAACAGT-1	LC_ER+
TTGTGAGGTTAAGCCA-1	LC_ER-
TTGTGAGGTTGGTGAC-1	LC_ER-
TTGTGCCTCACATTGA-1	LC_ER+
TTGTGCCTCCTCATCA-1	LC_ER-
TTGTGCGAGATGGAGC-1	Immature_BC
TTGTGTGCAAGGTGGC-1	LC_ER-
TTGTGTGCACGGTTTA-1	LC_ER+
TTGTGTGCACTTCATC-1	LC_ER+
TTGTTCCCACCCTCAC-1	LC_ER+
TTGTTCCCAGCTCAAC-1	LC_ER+
TTGTTCCCAGGCGAGT-1	LC_ER-
TTGTTCCCAGTCTATG-1	LC_ER+
TTGTTCCCATAGACTT-1	LC_ER+
TTGTTCCCATTGTGGC-1	LC_ER-
TTGTTGCGTTACCTGT-1	LC_ER-
TTGTTGCGTTAGTACG-1	LC_ER-
TTGTTGTTCAATCATG-1	LC_ER-
TTGTTGTTCCCTCACG-1	LC_ER-
TTGTTGTTCCGGCTAA-1	LC_ER-
TTGTTTGGTCTCACTG-1	HY_ER+_ER-
TTGTTTGGTGTGAGAG-1	HY_ER+_ER-
TTGTTTGGTTAAATGC-1	LC_ER+
TTTAACCTCATTGTTC-1	Immature_BC
TTTAACCTCTCCTCAA-1	LC_ER+
TTTAACGAGACTTACA-1	HY_ER+_ER-
TTTAACGAGATGGACA-1	Immature_BC
TTTAACGAGTAAAGGT-1	Immature_BC
TTTAAGCCAAAGCCTC-1	LC_ER+
TTTAAGCCAATTAAGG-1	LC_ER+
TTTAAGCCAATTAGGA-1	LC_ER-
TTTAAGGTCAGCATTA-1	LC_ER+
TTTAAGGTCCGGTTGA-1	Immature_BC
TTTACGAAGCCTCTCG-1	LC_ER-
TTTACGAAGTCATTTC-1	LC_ER+
TTTACGAAGTGAGCGG-1	LC_ER+
TTTACGCGTAGTAAGA-1	LC_ER-
TTTACGCGTCATGCAA-1	LC_ER-
TTTACGCGTGCTCACC-1	LC_ER+
TTTACGCGTGTAACCA-1	Immature_BC
TTTAGCAAGAAAGCAT-1	HY_ER+_ER-
TTTAGCAAGTCGCTAG-1	Immature_BC
TTTAGCTTCAGCAAGA-1	Immature_BC
TTTAGGATCCAAGTGT-1	LC_ER-
TTTATGGAGATAGACG-1	LC_ER-
TTTATGGAGGCGCTTA-1	LC_ER-
TTTATGGAGGTCCTAG-1	Immature_BC
TTTATGGAGTATTGCA-1	LC_ER-
TTTATGGAGTCATTTC-1	LC_ER-
TTTATGGAGTTAGCCG-1	LC_ER+
TTTCACCCACCAGGTT-1	LC_ER+
TTTCACCCAGAGGGAG-1	LC_ER+
TTTCACCCAGGTTCAC-1	LC_ER-
TTTCACCCATAAGTCT-1	LC_ER+
TTTCACCCATAGTCAT-1	Immature_BC
TTTCACCCATTAGGCC-1	LC_ER+
TTTCACCCATTGACAT-1	LC_ER+
TTTCAGTTCCATAAGC-1	LC_ER+
TTTCAGTTCCTTGTTG-1	Immature_BC
TTTCAGTTCGATTTAG-1	Immature_BC
TTTCAGTTCTCAATGA-1	HY_ER+_ER-
TTTCAGTTCTGTTGCC-1	LC_ER-
TTTCAGTTCTTGCAAA-1	LC_ER-
TTTCATCAGGGACCTC-1	LC_ER+
TTTCATCAGTTATGGC-1	LC_ER-
TTTCCACCAAGTTATC-1	LC_ER-
TTTCCACCACCAACCG-1	LC_ER-
TTTCCGGGTCACCTAT-1	Immature_BC
TTTCCGGGTGATTACG-1	Immature_BC
TTTCCGGGTTAACACG-1	LC_ER+
TTTCCTGAGGTTACGT-1	LC_ER+
TTTCCTGAGGTTTGCG-1	LC_ER+
TTTCCTGAGTCAATTG-1	LC_ER+
TTTCGTCCAATTGAGA-1	LC_ER-
TTTCGTCCACATGCTA-1	LC_ER-
TTTCGTCCAGATTCAT-1	LC_ER+
TTTCGTCCATGTTGGC-1	LC_ER+
TTTCTCACAATAGCAA-1	HY_BC_ER+
TTTCTCACAGGATTAA-1	LC_ER+
TTTCTCACAGGCATGA-1	LC_ER+
TTTCTTGCACAGCCAT-1	LC_ER+
TTTCTTGCACTGACTA-1	LC_ER+
TTTCTTGCAGTAAAGC-1	LC_ER+
TTTCTTGCAGTAAGTA-1	LC_ER+
TTTCTTGCATGAGTTT-1	Immature_BC
TTTCTTGCATTTGCTC-1	LC_ER+
TTTGACCGTAACCACA-1	HY_BC_ER+
TTTGACCGTACGTTTC-1	LC_ER+
TTTGACCGTCATGCCC-1	LC_ER+
TTTGACCGTCCTTAGT-1	LC_ER+
TTTGACTTCGGGATTT-1	LC_ER-
TTTGACTTCTAGCGAT-1	LC_ER+
TTTGCATTCAATAGCC-1	HY_ER+_ER-
TTTGCATTCAGCAAGA-1	LC_ER-
TTTGCATTCCCATAAA-1	LC_ER+
TTTGCGACACCGTTCC-1	LC_ER+
TTTGCGACAGCAAGGC-1	LC_ER+
TTTGCGACAGCTCATA-1	LC_ER+
TTTGCGACAGGCGAGT-1	LC_ER-
TTTGCGGAGGCAACAA-1	HY_ER+_ER-
TTTGCGGAGGTCTTGG-1	LC_ER+
TTTGGCTGTACTTCAC-1	HY_ER+_ER-
TTTGGCTGTAGGATTT-1	LC_ER-
TTTGGCTGTGATGATT-1	LC_ER+
TTTGGCTGTTAATGAC-1	LC_ER+
TTTGGTAAGCCATCAG-1	LC_ER+
TTTGGTAAGCGAAGTA-1	LC_ER+
TTTGGTAAGGACCTGC-1	LC_ER-
TTTGGTAAGGCACAGG-1	LC_ER+
TTTGGTAAGGCCGGAA-1	LC_ER-
TTTGGTAAGTGAGGTA-1	Immature_BC
TTTGGTAAGTTAACCA-1	LC_ER+
TTTGGTAAGTTTAACG-1	Immature_BC
TTTGGTGCACCAGCAT-1	LC_ER+
TTTGGTGCAGAATGAC-1	LC_ER+
TTTGGTGCAGCCTAAC-1	LC_ER+
TTTGGTGCATAAGTTC-1	LC_ER-
TTTGTCCCAGGCCATT-1	LC_ER-
TTTGTCCCATAGCTGC-1	LC_ER+
TTTGTCCCATGTTGGC-1	LC_ER+
TTTGTCTAGTCAGGCC-1	LC_ER-
TTTGTCTAGTTAGAGG-1	LC_ER+
TTTGTCTAGTTGTCCC-1	LC_ER-
TTTGTGAAGCCAGTAT-1	LC_ER+
TTTGTGAAGCCTCTGT-1	LC_ER-
TTTGTGAAGCGGTTAT-1	LC_ER+
TTTGTGAAGTGGCGGA-1	Immature_BC
TTTGTGGCAGCCAGAA-1	LC_ER+
TTTGTGGCAGGCATGA-1	HY_ER+_ER-
TTTGTGGCATAGACCC-1	LC_ER-
TTTGTGGCATAGCGGA-1	LC_ER-
TTTGTGTTCCGGGACT-1	LC_ER-
TTTGTGTTCGTGCTTC-1	LC_ER+
TTTGTGTTCTTGCTAT-1	LC_ER-
TTTGTTGGTTGCATCT-1	LC_ER+
